1661	S IH K S T IY N S IH K S T IY W AA N 
18,	EY T IY N 
1858.	EY T IY N F IH F T IY EY T 
1888	EY T IY N EY T IY EY T 
1890.	EY T IY N N AY N T IY 
2002	T UW TH AW Z AH N D T UW 
2011	T UW TH AW Z AH N D IH L EH V AH N 
27,	T W EH N T IY S EH V AH N 
29,	T W EH N T IY N AY N 
4	F AO R 
5:15	F AY V F IH F T IY N 
7	S EH V AH N 
a	AH
a(2)	EY
A	AH
A(2)	EY
A,	AH
A,(2)	EY
A.,	AH
A.,(2)	EY
abandoned	AH B AE N D AH N D
abhorrent	AE B HH AO R AH N T
able	EY B AH L
about	AH B AW T
above	AH B AH V
abruptly	AH B R AH P T L IY
absolute	AE B S AH L UW T
absolutely	AE B S AH L UW T L IY
Absolutely	AE B S AH L UW T L IY
Absolutely?	AE B S AH L UW T L IY
absorb	AH B Z AO R B
accent.	AH K S EH N T
accent.(2)	AE K S EH N T
accomplice.	AH K AA M P L AH S
accomplished	AH K AA M P L IH SH T
account	AH K AW N T
accustomed	AH K AH S T AH M D
Accustomed	AH K AH S T AH M D
acknowledges	AE K N AA L IH JH IH Z
acknowledges(2)	IH K N AA L IH JH IH Z
acquaintance	AH K W EY N T AH N S
across	AH K R AO S
action.	AE K SH AH N
actions.	AE K SH AH N Z
active	AE K T IH V
activity,	AE K T IH V AH T IY
activity,(2)	AE K T IH V IH T IY
actor,	AE K T ER
actress	AE K T R AH S
acute	AH K Y UW T
added,	AE D AH D
added,(2)	AE D IH D
addition,	AH D IH SH AH N
address	AE D R EH S
address(2)	AH D R EH S
address?	AE D R EH S
address?(2)	AH D R EH S
address.	AE D R EH S
address.(2)	AH D R EH S
addressing	AH D R EH S IH NG
adjusted	AH JH AH S T AH D
adjusted(2)	AH JH AH S T IH D
Adler	AE D L ER
Adler,	AE D L ER
Adler?	AE D L ER
Adler.	AE D L ER
ADLER.	AE D L ER
admirable	AE D M ER AH B AH L
admirable(2)	AE D M R AH B AH L
admirably	AE D M ER AH B L IY
admit	AH D M IH T
adopted	AH D AA P T AH D
advantage	AE D V AE N T IH JH
advantage(2)	AH D V AE N T IH JH
advantage(3)	AE D V AE N IH JH
advantage(4)	AH D V AE N AH JH
advantages	AE D V AE N T IH JH IH Z
advantages(2)	AH D V AE N T IH JH IH Z
advantages(3)	AE D V AE N IH JH IH Z
advantages(4)	AH D V AE N IH JH IH Z
Adventure	AE D V EH N CH ER
Adventure(2)	AH D V EH N CH ER
ADVENTURE	AE D V EH N CH ER
ADVENTURE(2)	AH D V EH N CH ER
Adventures	AE D V EH N CH ER Z
Adventures(2)	AH D V EH N CH ER Z
ADVENTURES	AE D V EH N CH ER Z
ADVENTURES(2)	AH D V EH N CH ER Z
adventures.	AE D V EH N CH ER Z
adventures.(2)	AH D V EH N CH ER Z
adventuress,	AE D V EH N CH ER AH S 
advertisement	AH D V ER T AH Z M AH N T
advertisement(2)	AE D V ER T AY Z M AH N T
advertisement,	AH D V ER T AH Z M AH N T
advertisement,(2)	AE D V ER T AY Z M AH N T
advertisement.	AH D V ER T AH Z M AH N T
advertisement.(2)	AE D V ER T AY Z M AH N T
advise	AE D V AY Z
advise(2)	AH D V AY Z
affair	AH F EH R
affair,	AH F EH R
affairs,	AH F EH R Z
affect	AH F EH K T
afraid	AH F R EY D
after	AE F T ER
After	AE F T ER
after.	AE F T ER
afternoon	AE F T ER N UW N
afterwards	AE F T ER W ER D Z
again	AH G EH N
again(2)	AH G EY N
again,	AH G EH N
again,(2)	AH G EY N
again;	AH G EH N
again;(2)	AH G EY N
again.	AH G EH N
again.(2)	AH G EY N
against	AH G EH N S T
against(2)	AH G EY N S T
age	EY JH
age.	EY JH
agent	EY JH AH N T
agitation.	AE JH AH T EY SH AH N
ago,	AH G OW
ago.	AH G OW
Ah,	AA
air	EH R
air,	EH R
air.	EH R
aisle	AY L
aisle(2)	AY AH L
akin	AH K IH N
akin(2)	EY K IH N
alarm	AH L AA R M
alarm,	AH L AA R M
alarm.	AH L AA R M
Albert	AE L B ER T
all	AO L
All	AO L
all-important.	AO L IH M P AO R T AH N T 
all,	AO L
all;	AO L
all.	AO L
almost	AO L M OW S T
alone	AH L OW N
alone.	AH L OW N
aloud.	AH L AW D
already	AO L R EH D IY
already(2)	AO R EH D IY
already,	AO L R EH D IY
already,(2)	AO R EH D IY
also	AO L S OW
also.	AO L S OW
altar	AO L T ER
altar,	AO L T ER
altar.	AO L T ER
alternating	AO L T ER N EY T IH NG
altogether	AO L T AH G EH DH ER
Altogether,	AO L T AH G EH DH ER
always	AO L W EY Z
always(2)	AO L W IY Z
am	AE M
am(2)	EY EH M
am.	AE M
am.(2)	EY EH M
amazement.	AH M EY Z M AH N T
amazing	AH M EY Z IH NG
ambition,	AE M B IH SH AH N
American	AH M EH R AH K AH N
American(2)	AH M EH R IH K AH N
amiable	EY M IY AH B AH L
amiss	AH M IH S
among	AH M AH NG
amount	AH M AW N T
an	AE N
an(2)	AH N
and	AH N D
and(2)	AE N D
And	AH N D
And(2)	AE N D
and,	AH N D
and,(2)	AE N D
animated.	AE N AH M EY T AH D
animated.(2)	AE N AH M EY T IH D
announcement.	AH N AW N S M AH N T
announcement.(2)	AH N AW N S M EH N T
annoyance.	AH N OY AH N S
anonymous	AH N AA N AH M AH S
another	AH N AH DH ER
another,	AH N AH DH ER
another.	AH N AH DH ER
answer	AE N S ER
answered	AE N S ER D
answered,	AE N S ER D
answered.	AE N S ER D
antagonist;	AE N T AE G AH N AH S T
anxiety.	AE NG Z AY AH T IY
anxious	AE NG K SH AH S
anxious(2)	AE NG SH AH S
any	EH N IY
anyhow,	EH N IY HH AW
anyone	EH N IY W AH N
anything	EH N IY TH IH NG
anywhere	EH N IY W EH R
anywhere(2)	EH N IY HH W EH R
apart	AH P AA R T
apiece.	AH P IY S
apology	AH P AA L AH JH IY
apparent	AH P EH R AH N T
apparently	AH P EH R AH N T L IY
appearance	AH P IH R AH N S
appearance.	AH P IH R AH N S
appeared	AH P IH R D
appears	AH P IH R Z
apply	AH P L AY
Apply	AH P L AY
apply,	AH P L AY
apply.	AH P L AY
applying	AH P L AY IH NG
April	EY P R AH L
aquiline,	AE K W IY L AY N 
arc-and-compass	AA R K AE N D K AA M P AH S 
are	AA R
are(2)	ER
Are	AA R
Are(2)	ER
are,	AA R
are,(2)	ER
are?	AA R
are?(2)	ER
are.	AA R
are.(2)	ER
arm	AA R M
armchair	AA R M CH EH R
armchair,	AA R M CH EH R
armchair.	AA R M CH EH R
arms.	AA R M Z
Arnsworth	AA R N Z W ER TH 
around	ER AW N D
around(2)	ER AW N
arranged	ER EY N JH D
arrangements.	ER EY N JH M AH N T S
arrest?	ER EH S T
arrived.	ER AY V D
Arthur	AA R TH ER
ARTHUR	AA R TH ER
as	AE Z
as(2)	EH Z
As	AE Z
As(2)	EH Z
as,	AE Z
as,(2)	EH Z
ashamed	AH SH EY M D
ask	AE S K
asked	AE S K T
asked(2)	AE S T
asked.	AE S K T
asked.(2)	AE S T
asks.	AE S K S
assistant	AH S IH S T AH N T
assistant,	AH S IH S T AH N T
assistants,	AH S IH S T AH N T S
assisting	AH S IH S T IH NG
associated	AH S OW S IY EY T AH D
associated(2)	AH S OW SH IY EY T AH D
assumed.	AH S UW M D
assuring	AH SH UH R IH NG
astrakhan	AE S T R AH K AA N
at	AE T
At	AE T
Atkinson	AE T K AH N S AH N
Atkinson(2)	AE T K IH N S AH N
attempt	AH T EH M P T
attempts	AH T EH M P T S
attempts(2)	AH T EH M P S
attend	AH T EH N D
attention	AH T EH N SH AH N
attention,	AH T EH N SH AH N
attention.	AH T EH N SH AH N
attitude	AE T AH T UW D
attracted	AH T R AE K T AH D
august	AA G AH S T
august(2)	AO G AH S T
authenticity?	AO TH AH N T IH S IH T IY
Author:	AO TH ER
authoritative	AH TH AO R AH T EY T IH V
autumn	AO T AH M
avail,	AH V EY L
Avenue,	AE V AH N UW
avenue.	AE V AH N UW
Avenue.	AE V AH N UW
average	AE V ER IH JH
average(2)	AE V R AH JH
average(3)	AE V R IH JH
averse	AH V ER S
awaiting	AH W EY T IH NG
aware	AH W EH R
away	AH W EY
Away	AH W EY
awkward,	AA K W ER D
awkward,(2)	AO K W ER D
baby;	B EY B IY
Bachelor	B AE CH AH L ER
Bachelor(2)	B AE CH L ER
bachelor.	B AE CH AH L ER
bachelor.(2)	B AE CH L ER
back	B AE K
back,	B AE K
back.	B AE K
backward,	B AE K W ER D
bad	B AE D
bad!	B AE D
bade	B EY D
baffled	B AE F AH L D
bag	B AE G
baggy	B AE G IY
Baker	B EY K ER
balanced	B AE L AH N S T
balancing	B AE L AH N S IH NG
Band	B AE N D
bands	B AE N D Z
banker	B AE NG K ER
barbaric	B AA R B AE R IH K
barbaric(2)	B AA R B EH R IH K
barrow.	B AE R OW
barrow.(2)	B EH R OW
bashful.	B AE SH F AH L
be	B IY
Be	B IY
be.	B IY
beamed	B IY M D
bear	B EH R
beaten	B IY T AH N
beauties.	B Y UW T IY Z
beautiful	B Y UW T AH F AH L
beautifully.	B Y UW T AH F L IY
became	B IH K EY M
became(2)	B IY K EY M
because	B IH K AO Z
because(2)	B IH K AH Z
because(3)	B IH K AA Z
Because	B IH K AO Z
Because(2)	B IH K AH Z
Because(3)	B IH K AA Z
becomes	B IH K AH M Z
bedroom	B EH D R UW M
bedroom,	B EH D R UW M
bedtime	B EH D T AY M
Beeches	B IY CH IH Z 
beef	B IY F
been	B IH N
been(2)	B AH N
been.	B IH N
been.(2)	B AH N
beer,	B IH R
before	B IH F AO R
before(2)	B IY F AO R
before,	B IH F AO R
before,(2)	B IY F AO R
before.	B IH F AO R
before.(2)	B IY F AO R
began	B IH G AE N
began(2)	B IY G AE N
begin	B IH G IH N
begin,	B IH G IH N
begins	B IH G IH N Z
behind	B IH HH AY N D
Behind	B IH HH AY N D
being	B IY IH NG
belief	B IH L IY F
belief,	B IH L IY F
believe	B IH L IY V
believe?	B IH L IY V
bell	B EH L
bell-pull,	B EH L P UH L 
bell-pull.	B EH L P UH L 
bell.	B EH L
below,	B IH L OW
below,(2)	B IY L OW
benefactor.	B EH N AH F AE K T ER
benevolent	B AH N EH V AH L AH N T
bequest	B IH K W EH S T
berths	B ER TH S
berths(2)	B ER DH Z
Beryl	B EH R AH L
beryl.	B EH R AH L
beside	B IH S AY D
beside(2)	B IY S AY D
Besides,	B IH S AY D Z
Besides,(2)	B IY S AY D Z
best	B EH S T
betrayed	B IH T R EY D
betrothal	B IH T R AA TH AO L 
better	B EH T ER
better-dressed	B EH T ER D R EH S T 
better.	B EH T ER
between	B IH T W IY N
between(2)	B IY T W IY N
Beyond	B IH AA N D
Beyond(2)	B IY AO N D
Beyond(3)	B IH AO N D
bijou	B AY JH UW 
billet	B IH L AH T
billet(2)	B IH L IH T
billet.	B IH L AH T
billet.(2)	B IH L IH T
binding	B AY N D IH NG
biographies	B AY AA G R AH F IY Z
biography	B AY AA G R AH F IY
bit	B IH T
bit,	B IH T
bizarre	B AH Z AA R
bizarre(2)	B IH Z AA R
black	B L AE K
blackest	B L AE K AH S T
blackmailing	B L AE K M EY L IH NG
blanche.	B L AE N CH
blazing	B L EY Z IH NG
blazing,	B L EY Z IH NG
blind.	B L AY N D
blinds	B L AY N D Z
blood	B L AH D
blotting-paper,	B L AA T IH NG P EY P ER 
blow	B L OW
blue	B L UW
Blue	B L UW
bob	B AA B
body	B AA D IY
Bohemia	B OW HH IY M IY AH
BOHEMIA	B OW HH IY M IY AH
Bohemia,	B OW HH IY M IY AH
Bohemia.	B OW HH IY M IY AH
Bohemian	B OW HH IY M IY AH N
bonnet	B AA N AH T
books,	B UH K S
boot-slitting	B UW T S L IH T IH NG 
Boots	B UW T S
bore	B AO R
Born	B AO R N
borne	B AO R N
Boscombe	B AO S K AH M 
Boswell.	B AA Z W EH L
both	B OW TH
both,	B OW TH
bottle	B AA T AH L
bought	B AA T
bought(2)	B AO T
bought.	B AA T
bought.(2)	B AO T
Bought.	B AA T
Bought.(2)	B AO T
bound	B AW N D
bowed	B AW D
bowed(2)	B OW D
bowed,	B AW D
bowed,(2)	B OW D
boy,	B OY
brassy	B R AE S IY
brave	B R EY V
breaking	B R EY K IH NG
breaks	B R EY K S
breastpin.	B R EH S T P IH N 
breathing	B R IY DH IH NG
brick,	B R IH K
bride	B R AY D
bridegroom	B R AY D G R UW M
briefly	B R IY F L IY
bright,	B R AY T
brilliantly	B R IH L Y AH N T L IY
bring	B R IH NG
Bring	B R IH NG
Briony	B R IY OW N IY 
Britannica.	B R IH T AE N IH K AH
British	B R IH T IH SH
broad	B R AO D
broad-brimmed	B R AO D B R IH M D 
broke	B R OW K
broken	B R OW K AH N
brooch	B R UW CH
brooch(2)	B R OW CH
brothers	B R AH DH ER Z
brougham	B R UW G AH M
brougham.	B R UW G AH M
brought	B R AO T
brown	B R AW N
brushed	B R AH SH T
buckles.	B AH K AH L Z
budge	B AH JH
building,	B IH L D IH NG
built	B IH L T
bulge	B AH L JH
burglars	B ER G L ER Z
burgled.	B ER G AH L D 
buried	B EH R IY D
burned,	B ER N D
busier	B IH Z IY ER
business	B IH Z N AH S
business(2)	B IH Z N IH S
business.	B IH Z N AH S
business.(2)	B IH Z N IH S
busy	B IH Z IY
but	B AH T
But	B AH T
but,	B AH T
But,	B AH T
butted	B AA T IH D 
by	B AY
By	B AY
By-the-way,	B AY DH AH W EY 
by.	B AY
cab	K AE B
cab,	K AE B
cab.	K AE B
cabby	K AE B IY
cabinet	K AE B AH N AH T
cabinet(2)	K AE B N AH T
cabinet?	K AE B AH N AH T
cabinet?(2)	K AE B N AH T
cabman	K AE B M AH N 
call	K AO L
call?	K AO L
call.	K AO L
called	K AO L D
calls	K AO L Z
calves,	K AE V Z
came	K EY M
camera	K AE M ER AH
camera(2)	K AE M R AH
campaign.	K AE M P EY N
can	K AE N
can(2)	K AH N
Can	K AE N
Can(2)	K AH N
can't	K AE N T
candid.	K AE N D AH D
candid.(2)	K AE N D IH D
candidate	K AE N D AH D EY T
candidate(2)	K AE N AH D IH T
cannot	K AE N AA T
cannot(2)	K AH N AA T
cap	K AE P
capable	K EY P AH B AH L
capital	K AE P AH T AH L
capital(2)	K AE P IH T AH L
Carbuncle	K AA R B AH N K AH L 
care	K EH R
cared	K EH R D
careful,	K EH R F AH L
carefully	K EH R F AH L IY
careless	K EH R L AH S
carelessly	K EH R L AH S L IY
Carlsbad.	K AA R L S B AE D
carpenter.	K AA R P AH N T ER
carriage	K AE R IH JH
carriage(2)	K EH R AH JH
carriage,	K AE R IH JH
carriage,(2)	K EH R AH JH
carriage.	K AE R IH JH
carriage.(2)	K EH R AH JH
carried	K AE R IY D
carried(2)	K EH R IY D
carries	K AE R IY Z
carries(2)	K EH R IY Z
carry	K AE R IY
carry(2)	K EH R IY
carte	K AA R T
case	K EY S
Case	K EY S
case,	K EY S
cases	K EY S AH Z
cases(2)	K EY S IH Z
cases,	K EY S AH Z
cases,(2)	K EY S IH Z
cases.	K EY S AH Z
cases.(2)	K EY S IH Z
Cassel-Felstein,	K AE S AH L F EH L S T AY N 
Castle	K AE S AH L
catch	K AE CH
caught	K AA T
caught(2)	K AO T
cause	K AA Z
cause(2)	K AO Z
cause.	K AA Z
cause.(2)	K AO Z
caused	K AA Z D
caused(2)	K AO Z D
ceased	S IY S T
celebrated	S EH L AH B R EY T AH D
celebrated(2)	S EH L AH B R EY T IH D
cellar	S EH L ER
centre	S EH N T ER
centuries	S EH N CH ER IY Z
certain	S ER T AH N
certainly	S ER T AH N L IY
Certainly,	S ER T AH N L IY
Certainly.	S ER T AH N L IY
certificates?	S ER T IH F IH K AH T S
chagrin	SH AH G R IH N
chain,	CH EY N
chair	CH EH R
chair,	CH EH R
chair.	CH EH R
chairs	CH EH R Z
chamber	CH EY M B ER
chambers	CH EY M B ER Z
chambers.	CH EY M B ER Z
chamois	CH AE M W AA 
chance	CH AE N S
chance.	CH AE N S
chances	CH AE N S AH Z
chances(2)	CH AE N S IH Z
change	CH EY N JH
changed	CH EY N JH D
character	K EH R IH K T ER
character,	K EH R IH K T ER
Charing	CH EH R IH NG 
chat	CH AE T
check	CH EH K
cheekbones,	CH IY K B OW N Z
cheer	CH IH R
chest	CH EH S T
child	CH AY L D
chin	CH IH N
China,	CH AY N AH
China?	CH AY N AH
China.	CH AY N AH
Chinese	CH AY N IY Z
choked	CH OW K T
chronicle	K R AA N IH K AH L
Chronicle	K R AA N IH K AH L
chronicle,	K R AA N IH K AH L
Chubb	CH AH B
chuckled	CH AH K AH L D
church	CH ER CH
Church	CH ER CH
church.	CH ER CH
cigar-shaped	S IH G AA R SH EY P T 
cigarette,	S IH G ER EH T
cigarette.	S IH G ER EH T
cigars	S IH G AA R Z
cigars,	S IH G AA R Z
circumstances	S ER K AH M S T AE N S AH Z
circumstances(2)	S ER K AH M S T AE N S IH Z
city	S IH T IY
City.	S IH T IY
civil	S IH V AH L
clapped	K L AE P T
clasped	K L AE S P T
clay;	K L EY
clean	K L IY N
clear	K L IH R
clear?	K L IH R
clear.	K L IH R
clearing	K L IH R IH NG
clergyman	K L ER JH IY M AH N
clergyman(2)	K L ER JH IY M AE N
clergyman,	K L ER JH IY M AH N
clergyman,(2)	K L ER JH IY M AE N
clergyman.	K L ER JH IY M AH N
clergyman.(2)	K L ER JH IY M AE N
clever,	K L EH V ER
cleverness	K L EH V ER N AH S
client	K L AY AH N T
client,	K L AY AH N T
client.	K L AY AH N T
cloak	K L OW K
close	K L OW S
close(2)	K L OW Z
closed	K L OW Z D
closely	K L OW S L IY
closely,	K L OW S L IY
closing	K L OW Z IH NG
clothes	K L OW DH Z
clothes(2)	K L OW Z
clothes,	K L OW DH Z
clothes,(2)	K L OW Z
Clotilde	K L OW T AY L D 
cloud	K L AW D
clouds	K L AW D Z
clues,	K L UW Z
clumsy	K L AH M Z IY
co-operation.	K OW AA P ER EY SH AH N 
Co.	K OW
coach-house.	K OW CH HH AW S 
coachman	K OW CH M AH N
coachman,	K OW CH M AH N
coat	K OW T
coat,	K OW T
cobbler's	K AA B L ER Z
Coburg	K OW B ER G 
cocaine	K OW K EY N
cocked	K AA K T
cocked(2)	K AO K T
coffee	K AA F IY
coffee(2)	K AO F IY
coin	K OY N
cold	K OW L D
cold,	K OW L D
coldly.	K OW L D L IY
collar	K AA L ER
colleague,	K AA L IY G
colour	K AA L ER 
colour,	K AA L ER 
colour.	K AA L ER 
column,	K AA L AH M
column.	K AA L AH M
combinations	K AA M B AH N EY SH AH N Z
come	K AH M
Come	K AH M
come,	K AH M
Come,	K AH M
Come!	K AH M
come.	K AH M
comes	K AH M Z
comes,	K AH M Z
comes.	K AH M Z
comfortable	K AH M F ER T AH B AH L
coming	K AH M IH NG
committed	K AH M IH T AH D
committed.	K AH M IH T AH D
common	K AA M AH N
commonplace	K AA M AH N P L EY S
communicate	K AH M Y UW N AH K EY T
companion,	K AH M P AE N Y AH N
companion.	K AH M P AE N Y AH N
companion's	K AH M P AE N Y AH N Z 
company	K AH M P AH N IY
Company.	K AH M P AH N IY
compelled	K AH M P EH L D
competition	K AA M P AH T IH SH AH N
complete	K AH M P L IY T
completed	K AH M P L IY T AH D
completed(2)	K AH M P L IY T IH D
completely.	K AH M P L IY T L IY
complimented	K AA M P L AH M EH N T IH D
comply	K AH M P L AY
compromise	K AA M P R AH M AY Z
compromised	K AA M P R AH M AY Z D
compromising	K AA M P R AH M AY Z IH NG
compunction	K AH M P AH NG K SH AH N
Conan	K OW N AH N
CONAN	K OW N AH N
conceal	K AH N S IY L
concealment	K AH N S IY L M AH N T
concerning	K AH N S ER N IH NG
concerts,	K AA N S ER T S
concerts,(2)	K AH N S ER T S
conclusion.	K AH N K L UW ZH AH N
condescend	K AA N D IH S EH N D
conditions	K AH N D IH SH AH N Z
conduct	K AH N D AH K T
conduct(2)	K AA N D AH K T
confess	K AH N F EH S
confidant.	K AA N F AH D AA N T
confide	K AH N F AY D
confined	K AH N F AY N D
congratulate	K AH N G R AE CH AH L EY T
congratulated	K AH N G R AE CH AH L EY T IH D
connected	K AH N EH K T AH D
connected(2)	K AH N EH K T IH D
considerable	K AH N S IH D ER AH B AH L
consisted	K AH N S IH S T AH D
consisted(2)	K AH N S IH S T IH D
conspiring,	K AH N S P AY R IH NG
construction	K AH N S T R AH K SH AH N
consult	K AH N S AH L T
consult,	K AH N S AH L T
consulting	K AH N S AH L T IH NG
Continent.	K AA N T AH N AH N T
Continental	K AA N T AH N EH N T AH L
Continental(2)	K AA N T AH N EH N AH L
continue	K AH N T IH N Y UW
continued	K AH N T IH N Y UW D
continued,	K AH N T IH N Y UW D
contraction	K AH N T R AE K SH AH N
Contralto	K AA N T R AA L T OW 
contrary,	K AA N T R EH R IY
contrary,(2)	K AH N T R EH R IY
contributed	K AH N T R IH B Y UW T IH D
conventions	K AH N V EH N SH AH N Z
conversation	K AA N V ER S EY SH AH N
conveyed	K AH N V EY D
cooking	K UH K IH NG
Copper	K AA P ER
copper,	K AA P ER
copy	K AA P IY
copying	K AA P IY IH NG
cordially.	K AO R JH AH L IY
corner	K AO R N ER
corner,	K AO R N ER
corner.	K AO R N ER
Coronet	K AO R AH N EH T
cost	K AA S T
cost(2)	K AO S T
coster's	K AO S T ER Z 
costume	K AA S T UW M
costume.	K AA S T UW M
couch,	K AW CH
couch.	K AW CH
could	K UH D
Count	K AW N T
country	K AH N T R IY
couple	K AH P AH L
course	K AO R S
course,	K AO R S
Court	K AO R T
Court,	K AO R T
Court.	K AO R T
crack	K R AE K
creature	K R IY CH ER
crib	K R IH B
cried	K R AY D
cried,	K R AY D
cried;	K R AY D
cried.	K R AY D
crime	K R AY M
crime,	K R AY M
crime.	K R AY M
crimes	K R AY M Z
crimes,	K R AY M Z
Cross	K R AO S
crowd	K R AW D
crowd,	K R AW D
crowded	K R AW D AH D
crowded(2)	K R AW D IH D
crown	K R AW N
Crown	K R AW N
cruelly	K R UW L IY
crusted	K R AH S T IH D
cry	K R AY
cuff	K AH F
curb,	K ER B
curiosity	K Y UH R IY AA S AH T IY
curled	K ER L D
curve	K ER V
custom	K AH S T AH M
customary	K AH S T AH M EH R IY
cuts.	K AH T S
daily	D EY L IY
daintiest	D EY N T IY AH S T 
dangling	D AE NG G AH L IH NG
dangling(2)	D AE NG G L IH NG
dared	D EH R D
daring	D EH R IH NG
dark	D AA R K
dark,	D AA R K
dark.	D AA R K
Darlington	D AA R L IH NG T AH N
dashed	D AE SH T
dashing,	D AE SH IH NG
data	D EY T AH
data(2)	D AE T AH
data.	D EY T AH
data.(2)	D AE T AH
Date:	D EY T
date.	D EY T
dated	D EY T IH D
daughter	D AO T ER
day	D EY
day,	D EY
days	D EY Z
days.	D EY Z
dead,	D EH D
deal	D IY L
dear	D IH R
Dear	D IH R
DEAR	D IH R
dear,	D IH R
dear!	D IH R
death	D EH TH
debts,	D EH T S
deceived	D IH S IY V D
deduce	D IH D UW S
deduction	D IH D AH K SH AH N
deduction.	D IH D AH K SH AH N
deep	D IY P
deep-sea	D IY P S IY 
deepest	D IY P AH S T
deeply	D IY P L IY
degrees	D IH G R IY Z
dejected;	D IH JH EH K T IH D
delay.	D IH L EY
delicacy,	D EH L AH K AH S IY
delicacy,(2)	D EH L IH K AH S IY
delicacy.	D EH L AH K AH S IY
delicacy.(2)	D EH L IH K AH S IY
delicate	D EH L AH K AH T
delicately	D EH L AH K AH T L IY
delight,	D IH L AY T
delighted.	D IH L AY T AH D
delighted.(2)	D IH L AY T IH D
departed.	D IH P AA R T AH D
departed.(2)	D IH P AA R T IH D
departure,	D IH P AA R CH ER
depended	D IH P EH N D AH D
depended(2)	D IH P EH N D IH D
depicted	D IH P IH K T AH D
depicted(2)	D IH P IH K T IH D
descended	D IH S EH N D AH D
descended(2)	D IH S EH N D IH D
description,	D IH S K R IH P SH AH N
desire	D IH Z AY ER
desires	D IH Z AY ER Z
desirous	D IH Z AY R AH S
desk?	D EH S K
despair;	D IH S P EH R
desperation,	D EH S P ER EY SH AH N
desperation,(2)	D EH S P ER EY SH IH N
detail	D IH T EY L
detail(2)	D IY T EY L
details,	D IH T EY L Z
details,(2)	D IY T EY L Z
determined	D IH T ER M AH N D
deuce	D UW S
develop	D IH V EH L AH P
developed.	D IH V EH L AH P T
devil,	D EH V AH L
did	D IH D
Did	D IH D
did,	D IH D
didn't	D IH D AH N T
didn't(2)	D IH D N T
didn't(3)	D IH D AH N
didn't(4)	D IH N T
die	D AY
died	D AY D
different	D IH F ER AH N T
different(2)	D IH F R AH N T
difficult	D IH F AH K AH L T
difficulties,	D IH F AH K AH L T IY Z
difficulties,(2)	D IH F IH K AH L T IY Z
dimly	D IH M L IY
dinner.	D IH N ER
direction	D ER EH K SH AH N
direction(2)	D IY R EH K SH IH N
direction(3)	D AY R EH K SH IH N
direction(4)	D IH R EH K SH IH N
direction,	D ER EH K SH AH N
direction,(2)	D IY R EH K SH IH N
direction,(3)	D AY R EH K SH IH N
direction,(4)	D IH R EH K SH IH N
directions	D ER EH K SH AH N Z
directions(2)	D IY R EH K SH IH N Z
directions(3)	D AY R EH K SH IH N Z
directions(4)	D IH R EH K SH IH N Z
directions,	D ER EH K SH AH N Z
directions,(2)	D IY R EH K SH IH N Z
directions,(3)	D AY R EH K SH IH N Z
directions,(4)	D IH R EH K SH IH N Z
dirty	D ER T IY
disappeared	D IH S AH P IH R D
disappeared(2)	D IH S AH P IY R D
disappointment	D IH S AH P OY N T M AH N T
discontent	D IH S K AH N T EH N T
discover	D IH S K AH V ER
discretion,	D IH S K R EH SH AH N
discuss	D IH S K AH S
disentangled	D IH S AH N T AE NG G AH L D 
disguises,	D IH S G AY Z IH Z
disgust	D IH S G AH S T
dismantled	D IH S M AE N T AH L D
dismantled(2)	D IH S M AE N AH L D
disqualify	D IH S K W AA L AH F AY
disreputable	D IH S R EH P Y AH T AH B AH L
distinction	D IH S T IH NG K SH AH N
distracting	D IH S T R AE K T IH NG
disturbing	D IH S T ER B IH NG
diverted	D AY V ER T IH D
diverted(2)	D IH V ER T IH D
diving	D AY V IH NG
do	D UW
Do	D UW
do,	D UW
do?	D UW
do.	D UW
docketing	D AA K AH T IH NG 
Doctor,	D AA K T ER
Doctor,(2)	D AO K T ER
Doctor.	D AA K T ER
Doctor.(2)	D AO K T ER
does	D AH Z
does(2)	D IH Z
does.	D AH Z
does.(2)	D IH Z
doing	D UW IH NG
doing.	D UW IH NG
doings:	D UW IH NG Z
don't	D OW N T
don't(2)	D OW N
done	D AH N
done.	D AH N
donna	D AA N AH
door	D AO R
door-mat.	D AO R M AE T 
door,	D AO R
door.	D AO R
double	D AH B AH L
double-breasted	D AA B AH L B R EH S T AH D 
double-edged	D AA B AH L EH JH D 
doubt	D AW T
doubt;	D AW T
doubting.	D AW T IH NG
doubts.	D AW T S
down	D AW N
down,	D AW N
Doyle	D OY L
DOYLE	D OY L
dozen	D AH Z AH N
Dr.	D R AY V
Dr.(2)	D AA K T ER
drab	D R AE B
draw	D R AO
drawers,	D R AO R Z
drawing	D R AO IH NG
drawing-room,	D R AO IH NG R UW M 
drawn,	D R AO N
dreadful	D R EH D F AH L
dreams	D R IY M Z
dress	D R EH S
dress,	D R EH S
dress.	D R EH S
dressed	D R EH S T
drew	D R UW
drifted	D R IH F T AH D
drifted(2)	D R IH F T IH D
drive	D R AY V
Drive	D R AY V
driven	D R IH V AH N
driver	D R AY V ER
drives	D R AY V Z
driving	D R AY V IH NG
drop	D R AA P
drop(2)	D R AO P
dropped	D R AA P T
drove	D R OW V
drowsiness	D R AW Z IY N AH S
drug-created	D R AA G K R IY EY T AH D 
drug,	D R AH G
drunken-looking	D R AA NG K AH N L UH K IH NG 
dryly.	D R AY L IY
dubious	D UW B IY AH S
Duke	D UW K
dull,	D AH L
Duncan	D AH NG K AH N
during	D UH R IH NG
during(2)	D Y UH R IH NG
during(3)	D ER IH NG
dusk,	D AH S K
duties?	D UW T IY Z
E	IY
each	IY CH
eagerly	IY G ER L IY
eagerly,	IY G ER L IY
ear,	IY R
ear,(2)	IH R
earn	ER N
earnestly,	ER N AH S T L IY
earning	ER N IH NG
ears,	IH R Z
ears,(2)	IY R Z
earth	ER TH
ease	IY Z
easily	IY Z AH L IY
east,	IY S T
easy	IY Z IY
eat,	IY T
eBook	EH B UH K 
EBook	EH B UH K 
EBOOK	EH B UH K 
eclipses	IH K L IH P S IH Z
eclipses(2)	IY K L IH P S IH Z
edges	EH JH AH Z
edges(2)	EH JH IH Z
Edgeware	EH JH W EH R 
effect	IH F EH K T
effect(2)	IY F EH K T
effect(3)	AH F EH K T
effects	IH F EH K T S
effects(2)	IH F EH K S
effects(3)	IY F EH K T S
effects(4)	IY F EH K S
effort	EH F ER T
effusive.	EH F Y UW S IH V
Eg.	EH G 
Eglonitz	EH G L AH N IH T S 
Eglow,	EH G L OW 
Egria.	EH G R IY AH 
eight	EY T
either	IY DH ER
either(2)	AY DH ER
either.	IY DH ER
either.(2)	AY DH ER
ejaculated	EH AE K Y AH L EY T IH D 
elbow	EH L B OW
elbowed	EH L B OW D
elderly	EH L D ER L IY
eleven	IH L EH V AH N
eleven(2)	IY L EH V AH N
eligible	EH L AH JH AH B AH L
eligible(2)	EH L IH JH AH B AH L
eligible.	EH L AH JH AH B AH L
eligible.(2)	EH L IH JH AH B AH L
else	EH L S
else?	EH L S
else.	EH L S
embellish	IH M B EH L IH SH
emerald	EH M R AH L D
emerald(2)	EH M ER R AH L D
emerged	IH M ER JH D
emerged(2)	IY M ER JH D
emerged,	IH M ER JH D
emerged,(2)	IY M ER JH D
emotion	IH M OW SH AH N
emotion(2)	IY M OW SH AH N
emotions,	IH M OW SH AH N Z
emotions,(2)	IY M OW SH AH N Z
employ√©	EH M P L OY 
employed	EH M P L OY D
employed(2)	IH M P L OY D
employers	EH M P L OY ER Z
employers(2)	IH M P L OY ER Z
employing	EH M P L OY IH NG
employing(2)	IH M P L OY IH NG
employs	EH M P L OY Z
employs(2)	IH M P L OY Z
empty	EH M P T IY
empty(2)	EH M T IY
Encyclopaedia	IH N S AY K L AH P IY D IY AH
Encyclopaedia(2)	IH N S AY K L OW P IY D IY AH
end	EH N D
end.	EH N D
endeavoured,	EH N D EH V ER D 
endeavouring	EH N D EH V ER IH NG 
ended	EH N D AH D
ended(2)	EH N D IH D
energetic	EH N ER JH EH T IH K
energy	EH N ER JH IY
engaged	EH N G EY JH D
engaged.	EH N G EY JH D
Engineer's	EH N JH AH N IY R Z
England,	IH NG G L AH N D
England?	IH NG G L AH N D
English	IH NG G L IH SH
English(2)	IH NG L IH SH
enormous	IH N AO R M AH S
enormous(2)	IH N AO R M IH S
enormous(3)	IY N AO R M AH S
enormous(4)	IY N AO R M IH S
enough	IH N AH F
enough(2)	IY N AH F
entangled	EH N T AE NG G AH L D
enter	EH N T ER
enter(2)	EH N ER
entered	EH N T ER D
entered(2)	EH N ER D
entered,	EH N T ER D
entered,(2)	EH N ER D
entered.	EH N T ER D
entered.(2)	EH N ER D
entertaining	EH N T ER T EY N IH NG
entertaining(2)	EH N ER T EY N IH NG
enthusiasm	IH N TH UW Z IY AE Z AH M
entirely	IH N T AY ER L IY
Entirely.	IH N T AY ER L IY
entitles	EH N T AY T AH L Z
epistle.	IH P IH S AH L
equalled.	IY K W AE L D 
equally	IY K W AH L IY
escaped	IH S K EY P T
especially	AH S P EH SH L IY
especially(2)	AH S P EH SH AH L IY
Esq.	IY EH S K Y UW 
establishment,	IH S T AE B L IH SH M AH N T
establishment,(2)	IY S T AE B L IH SH M AH N T
Europe	Y UH R AH P
Europe.	Y UH R AH P
European	Y UH R AH P IY AH N
even	IY V IH N
Even	IY V IH N
evening	IY V N IH NG
evening,	IY V N IH NG
evening.	IY V N IH NG
events	IH V EH N T S
events(2)	IY V EH N T S
events,	IH V EH N T S
events,(2)	IY V EH N T S
ever	EH V ER
ever,	EH V ER
every	EH V ER IY
every(2)	EH V R IY
Every	EH V ER IY
Every(2)	EH V R IY
everyday	EH V R IY D EY
everyone	EH V R IY W AH N
everything	EH V R IY TH IH NG
evidently	EH V AH D AH N T L IY
evil	IY V AH L
exactly	IH G Z AE K T L IY
exaggerated.	IH G Z AE JH ER EY T AH D
exaggerated.(2)	IH G Z AE JH ER EY T IH D
exalted	IH G Z AO L T IH D
examined	IH G Z AE M AH N D
example,	IH G Z AE M P AH L
exceedingly	IH K S IY D IH NG L IY
excellent	EH K S AH L AH N T
excellent!	EH K S AH L AH N T
excellent.	EH K S AH L AH N T
except	IH K S EH P T
exchange	IH K S CH EY N JH
excitedly,	IH K S AY T AH D L IY
excuse	IH K S K Y UW S
excuse(2)	IH K S K Y UW Z
excuses,	IH K S K Y UW S IH Z
excuses,(2)	IH K S K Y UW Z IH Z
expected,	IH K S P EH K T AH D
expected,(2)	IH K S P EH K T IH D
expected.	IH K S P EH K T AH D
expected.(2)	IH K S P EH K T IH D
expenses?	IH K S P EH N S AH Z
expenses?(2)	IH K S P EH N S IH Z
experience	IH K S P IH R IY AH N S
experiences,	IH K S P IH R IY AH N S IH Z
explain	IH K S P L EY N
explained	IH K S P L EY N D
explaining.	IH K S P L EY N IH NG
expostulating	IH K S P OW S CH AH L EY T IH NG 
expression	IH K S P R EH SH AH N
expression,	IH K S P R EH SH AH N
extended	IH K S T EH N D AH D
extended(2)	IH K S T EH N D IH D
extending	IH K S T EH N D IH NG
extra	EH K S T R AH
extraordinary	IH K S T R AO R D AH N EH R IY
extraordinary(2)	EH K S T R AH AO R D AH N EH R IY
extreme	IH K S T R IY M
eye	AY
eye,	AY
eyes	AY Z
eyes,	AY Z
eyes.	AY Z
Ezekiah	EH Z EH K AY AH 
face	F EY S
face,	F EY S
face.	F EY S
faced	F EY S T
fact	F AE K T
fact,	F AE K T
factor	F AE K T ER
facts	F AE K T S
facts(2)	F AE K S
facts.	F AE K T S
facts.(2)	F AE K S
faculties	F AE K AH L T IY Z
faded	F EY D AH D
faded(2)	F EY D IH D
fail	F EY L
failed.	F EY L D
failing	F EY L IH NG
fairly	F EH R L IY
fall	F AO L
fall(2)	F AA L
false	F AO L S
familiar	F AH M IH L Y ER
families	F AE M AH L IY Z
families(2)	F AE M L IY Z
family	F AE M AH L IY
family(2)	F AE M L IY
family?	F AE M AH L IY
family?(2)	F AE M L IY
family.	F AE M AH L IY
family.(2)	F AE M L IY
fancy,	F AE N S IY
far	F AA R
fare	F EH R
fare,	F EH R
fashion	F AE SH AH N
fashion.	F AE SH AH N
fast.	F AE S T
fasteners	F AE S AH N ER Z
fasteners(2)	F AE S N ER Z
faster,	F AE S T ER
fat-encircled	F AE T IH N S ER K AH L D 
fatal,	F EY T AH L
fathom.	F AE DH AH M
fault	F AO L T
fault,	F AO L T
faults,	F AO L T S
favour	F EY V ER 
favourable	F EY V ER AH B AH L 
fear	F IH R
features	F IY CH ER Z
features.	F IY CH ER Z
feet	F IY T
fell	F EH L
fellow	F EH L OW
fellow,	F EH L OW
felt	F EH L T
few	F Y UW
field	F IY L D
field.	F IY L D
fierce	F IH R S
fiery	F AY ER IY
fifty	F IH F T IY
figure	F IH G Y ER
figures,	F IH G Y ER Z
fill	F IH L
filled.	F IH L D
fills	F IH L Z
finally	F AY N AH L IY
find	F AY N D
finds	F AY N D Z
fine	F AY N
fine.	F AY N
finely	F AY N L IY
finger	F IH NG G ER
fingertips	F IH NG G ER T IH P S
finished.	F IH N IH SH T
fire	F AY ER
fire(2)	F AY R
fire,	F AY ER
fire,(2)	F AY R
Fire!	F AY ER
Fire!(2)	F AY R
fire.	F AY ER
fire.(2)	F AY R
firelight	F AY R L AY T 
first	F ER S T
First	F ER S T
fish	F IH SH
fishes.	F IH SH AH Z
fishes.(2)	F IH SH IH Z
fishes'	F IH SH AH Z
fishes'(2)	F IH SH IH Z
fists	F IH S T S
fitted	F IH T AH D
fitted(2)	F IH T IH D
five	F AY V
Five	F AY V
flame-coloured	F L EY M K AA L ER D 
flaming	F L EY M IH NG
flattened	F L AE T AH N D
Fleet	F L IY T
flight,	F L AY T
flight.	F L AY T
flirting	F L ER T IH NG
floor,	F L AO R
florid-faced,	F L AO R AH D F EY S T 
flurried	F L ER IY D
flushed	F L AH SH T
folk	F OW K
folk,	F OW K
follow	F AA L OW
followed	F AA L OW D
following	F AA L OW IH NG
follows:	F AA L OW Z
food,	F UW D
foolscap	F UW L S K AE P 
foot	F UH T
for	F AO R
for(2)	F ER
for(3)	F R ER
For	F AO R
For(2)	F ER
For(3)	F R ER
for,	F AO R
for,(2)	F ER
for,(3)	F R ER
for.	F AO R
for.(2)	F ER
for.(3)	F R ER
forced	F AO R S T
forefinger	F AO R F IH NG G ER
forefinger,	F AO R F IH NG G ER
forehead,	F AO R HH EH D
forehead;	F AO R HH EH D
forever.	F ER EH V ER
forfeit	F AO R F IH T
Forgery.	F AO R JH ER IY
forgot	F ER G AA T
forgot(2)	F AO R G AA T
form	F AO R M
former	F AO R M ER
former,	F AO R M ER
formerly	F AO R M ER L IY
formidable	F AO R M AH D AH B AH L
formidable(2)	F AO R M IH D AH B AH L
formidable,	F AO R M AH D AH B AH L
formidable,(2)	F AO R M IH D AH B AH L
fortunate	F AO R CH AH N AH T
fortunate(2)	F AO R CH UW N AH T
fortunate,	F AO R CH AH N AH T
fortunate,(2)	F AO R CH UW N AH T
fortune	F AO R CH AH N
fortune(2)	F AO R CH UW N
fortune.	F AO R CH AH N
fortune.(2)	F AO R CH UW N
fortunes.	F AO R CH AH N Z
fortunes.(2)	F AO R CH UW N Z
forward	F AO R W ER D
forward,	F AO R W ER D
found	F AW N D
found,	F AW N D
founded	F AW N D AH D
founded(2)	F AW N D IH D
four	F AO R
Four	F AO R
fourteen,	F AO R T IY N
fraud,	F R AO D
frayed	F R EY D
freedom	F R IY D AH M
freely	F R IY L IY
Freemason,	F R IY M EY S AH N
freemasonry	F R IY M EY S AH N R IY
Freemasonry?	F R IY M EY S AH N R IY
Frenchman	F R EH N CH M AE N
frequently	F R IY K W AH N T L IY
frequently(2)	F R IY K W EH N T L IY
Frequently.	F R IY K W AH N T L IY
Frequently.(2)	F R IY K W EH N T L IY
fresh	F R EH SH
Friday	F R AY D IY
Friday(2)	F R AY D EY
friend	F R EH N D
friend,	F R EH N D
friend's	F R EH N D Z
friend's(2)	F R EH N Z
fro	F R OW
frock-coat,	F R AA K K OW T 
from	F R AH M
from(2)	F ER M
From	F R AH M
From(2)	F ER M
front	F R AH N T
front,	F R AH N T
front.	F R AH N T
fronts	F R AH N T S
full	F UH L
fund	F AH N D
funny.	F AH N IY
fur,	F ER
furnish	F ER N IH SH
furnished,	F ER N IH SH T
furniture	F ER N IH CH ER
future	F Y UW CH ER
future.	F Y UW CH ER
G	JH IY
g,	JH IY
G'	JH IY
gain	G EY N
gain.	G EY N
gang,	G AE NG
garden	G AA R D AH N
garden.	G AA R D AH N
gasogene	G AE Z OW JH IY N 
gave	G EY V
gaze.	G EY Z
gazed	G EY Z D
Gazetteer.	G AH Z EH T IH R 
general	JH EH N ER AH L
general(2)	JH EH N R AH L
generally	JH EH N ER AH L IY
generally(2)	JH EH N R AH L IY
gentleman	JH EH N T AH L M AH N
gentleman(2)	JH EH N AH L M AH N
gentleman,	JH EH N T AH L M AH N
gentleman,(2)	JH EH N AH L M AH N
gentleman's	JH EH N T AH L M AH N Z
gentleman's(2)	JH EH N AH L M AH N Z
gentlemen,	JH EH N T AH L M IH N
gentlemen,(2)	JH EH N AH L M IH N
German	JH ER M AH N
German-speaking	JH ER M AH N S P IY K IH NG 
German.	JH ER M AH N
Gesellschaft,	G AH S EH L SH AE F T
gesture	JH EH S CH ER
get	G EH T
get(2)	G IH T
gets	G EH T S
gets(2)	G IH T S
getting	G EH T IH NG
getting(2)	G IH T IH NG
Getting	G EH T IH NG
Getting(2)	G IH T IH NG
gibe	JH AY B
gigantic	JH AY G AE N T IH K
gigantic(2)	JH AY G AE N IH K
girl	G ER L
girl?	G ER L
give	G IH V
given	G IH V AH N
given(2)	G IH V IH N
gives.	G IH V Z
glad	G L AE D
glad,	G L AE D
glance	G L AE N S
glanced	G L AE N S T
glances.	G L AE N S IH Z
glancing	G L AE N S IH NG
glass	G L AE S
glass-factories	G L AE S F AE K T ER IY Z 
gleam	G L IY M
glimpse	G L IH M P S
glimpses	G L IH M P S IH Z
go	G OW
go,	G OW
God,	G AA D
Godfrey	G AA D F R IY
goes	G OW Z
going	G OW IH NG
going(2)	G OW IH N
gold	G OW L D
golden	G OW L D AH N
gone	G AO N
gone.	G AO N
good	G UH D
good(2)	G IH D
good-bye,	G IH D B AY
good-bye,(2)	G UH D B AY
good-day,	G UH D D EY 
good-fortune,	G UH D F AO R CH AH N 
good-morning.	G UH D M AO R N IH NG 
good-night,	G UH D N AY T 
Good-night,	G UH D N AY T 
good.	G UH D
good.(2)	G IH D
gospel,	G AA S P AH L
gospel,(2)	G AO S P AH L
got	G AA T
Gottsreich	G AA T S R AY K 
grabs	G R AE B Z
grace	G R EY S
Grand	G R AE N D
grasp	G R AE S P
grasping	G R AE S P IH NG
grating	G R EY T IH NG
gravely,	G R EY V L IY
great	G R EY T
greatcoat.	G R EY T K OW T 
greatest	G R EY T AH S T
greeting	G R IY T IH NG
greeting,	G R IY T IH NG
grey	G R EY
grim	G R IH M
Grit	G R IH T
groan	G R OW N
groom	G R UW M
groom,	G R UW M
Gross	G R OW S
ground,	G R AW N D
ground.	G R AW N D
group	G R UW P
grow	G R OW
grown	G R OW N
guardianship,	G AA R D IY AH N SH IH P
guardsmen	G AA R D Z M IH N
guardsmen,	G AA R D Z M IH N
guess	G EH S
guessed	G EH S T
guide	G AY D
guinea	G IH N IY
guineas	G IH N IY Z
Gutenberg	G UW T AH N B ER G
GUTENBERG	G UW T AH N B ER G
Gutenberg's	G AA T AH N B ER G Z 
ha,	HH AA
ha,(2)	EY CH EY
Ha,	HH AA
Ha,(2)	EY CH EY
ha!	HH AA
ha!(2)	EY CH EY
habit	HH AE B AH T
habit,	HH AE B AH T
habits,	HH AE B AH T S
habits.	HH AE B AH T S
had	HH AE D
hadn't	HH AE D AH N T
hadn't(2)	HH AE D AH N
hair	HH EH R
hair.	HH EH R
half	HH AE F
Half	HH AE F
half-buttoned,	HH AE F B AA T AH N D 
half-dragged	HH AE F D R AE G D 
half-drew	HH AE F D R UW 
half,	HH AE F
halfway	HH AE F W EY
hall	HH AO L
hall,	HH AO L
hand	HH AE N D
hand,	HH AE N D
hand.	HH AE N D
handed	HH AE N D AH D
handed(2)	HH AE N D IH D
hands	HH AE N D Z
hands(2)	HH AE N Z
hands,	HH AE N D Z
hands,(2)	HH AE N Z
hands.	HH AE N D Z
hands.(2)	HH AE N Z
handsome	HH AE N S AH M
handsome,	HH AE N S AH M
handy.	HH AE N D IY
hanging	HH AE NG IH NG
hanging(2)	HH AE NG G IH NG
Hankey's	HH AE NG K IY Z 
hansom	HH AE N S AH M
happiness,	HH AE P IY N AH S
hard	HH AA R D
hardened	HH AA R D AH N D
hardly	HH AA R D L IY
Hare	HH EH R
harness	HH AA R N AH S
harness(2)	HH AA R N IH S
harness.	HH AA R N AH S
harness.(2)	HH AA R N IH S
harsh	HH AA R SH
has	HH AE Z
has(2)	HH AH Z
Has	HH AE Z
Has(2)	HH AH Z
hat	HH AE T
hat,	HH AE T
have	HH AE V
Have	HH AE V
having	HH AE V IH NG
he	HH IY
He	HH IY
he,	HH IY
he;	HH IY
he.	HH IY
he'll	HH IY L
he's	HH IY Z
He's	HH IY Z
head	HH EH D
head,	HH EH D
head?	HH EH D
head.	HH EH D
heads	HH EH D Z
hear	HH IY R
heard	HH ER D
heard.	HH ER D
heart,	HH AA R T
heartily	HH AA R T AH L IY
heavily.	HH EH V AH L IY
heavy	HH EH V IY
Heavy	HH EH V IY
Hebrew	HH IY B R UW
heels	HH IY L Z
height,	HH AY T
held	HH EH L D
help	HH EH L P
help,	HH EH L P
helper	HH EH L P ER
helpless,	HH EH L P L AH S
Hence,	HH EH N S
her	HH ER
Her	HH ER
her,	HH ER
her.	HH ER
Hercules.	HH ER K Y AH L IY Z
here	HH IY R
Here	HH IY R
here's	HH IH R Z
hereditary	HH ER EH D AH T EH R IY
herself	HH ER S EH L F
hesitate,	HH EH Z AH T EY T
hesitated	HH EH Z IH T EY T IH D
high	HH AY
high-power	HH AY P AW ER 
highly,	HH AY L IY
him	HH IH M
him(2)	IH M
him,	HH IH M
him,(2)	IH M
him!	HH IH M
him!(2)	IH M
him.	HH IH M
him.(2)	IH M
himself	HH IH M S EH L F
hindrance	HH IH N D R AH N S
his	HH IH Z
His	HH IH Z
his.	HH IH Z
history.	HH IH S T ER IY
history.(2)	HH IH S T R IY
hoarsely.	HH AO R S L IY 
hoax	HH OW K S
Hold	HH OW L D
hole	HH OW L
holiday,	HH AA L AH D EY
holiday,(2)	HH AA L IH D EY
Holland.	HH AA L AH N D
Holmes	HH OW M Z
Holmes(2)	HH OW L M Z
HOLMES	HH OW M Z
HOLMES(2)	HH OW L M Z
Holmes,	HH OW M Z
Holmes,(2)	HH OW L M Z
HOLMES,	HH OW M Z
HOLMES,(2)	HH OW L M Z
Holmes;	HH OW M Z
Holmes;(2)	HH OW L M Z
Holmes?	HH OW M Z
Holmes?(2)	HH OW L M Z
Holmes.	HH OW M Z
Holmes.(2)	HH OW L M Z
Holmes'	HH OW M Z
Holmes'(2)	HH OW L M Z
home	HH OW M
home-centred	HH OW M S EH N T ER D 
home.	HH OW M
honour	AA N ER 
honourable	AA N ER AH B AH L 
hoofs	HH UH F S
hoofs(2)	HH UW F S
hope	HH OW P
hope,	HH OW P
hopeless	HH OW P L AH S
hopes	HH OW P S
hopes?	HH OW P S
hopes.	HH OW P S
Hopkins,	HH AA P K IH N Z
horses	HH AO R S AH Z
horses(2)	HH AO R S IH Z
horses,	HH AO R S AH Z
horses,(2)	HH AO R S IH Z
horses'	HH AO R S AH Z
horses'(2)	HH AO R S IH Z
horsey	HH AO R S IY
hospital.	HH AA S P IH T AH L
hot	HH AA T
hour	AW ER
hour(2)	AW R
hour,	AW ER
hour,(2)	AW R
hours	AW ER Z
hours(2)	AW R Z
hours?	AW ER Z
hours?(2)	AW R Z
house	HH AW S
House	HH AW S
house,	HH AW S
house.	HH AW S
household,	HH AW S HH OW L D
houses	HH AW S AH Z
houses(2)	HH AW S IH Z
how	HH AW
How	HH AW
How,	HH AW
how?	HH AW
however	HH AW EH V ER
however,	HH AW EH V ER
However,	HH AW EH V ER
however.	HH AW EH V ER
huge	HH Y UW JH
huge(2)	Y UW JH
hum!	HH AH M
Hum!	HH AH M
human	HH Y UW M AH N
human(2)	Y UW M AH N
humdrum	HH AH M D R AH M
hundred	HH AH N D R AH D
hundred(2)	HH AH N D R IH D
hundred(3)	HH AH N ER D
hundred(4)	HH AH N D ER D
hundreds	HH AH N D R AH D Z
hundreds(2)	HH AH N D ER D Z
hundreds(3)	HH AH N ER D Z
hungrily	HH AH NG G R AH L IY
hurled	HH ER L D
hurried	HH ER IY D
hurriedly	HH ER IY D L IY
hurry,	HH ER IY
hurt?	HH ER T
husband	HH AH Z B AH N D
husband,	HH AH Z B AH N D
husband.	HH AH Z B AH N D
I	AY
I,	AY
I;	AY
I.	AY
I've	AY V
ideas	AY D IY AH Z
Identity	AY D EH N T AH T IY
Identity(2)	AY D EH N T IH T IY
Identity(3)	AY D EH N IH T IY
Identity(4)	AY D EH N AH T IY
idler	AY D AH L ER
idler(2)	AY D L ER
if	IH F
If	IH F
ignotum	IH G N AA T AH M 
II.	AY AY 
III.	AY AY AY 
ill	IH L
ill-kempt	IH L K EH M P T 
imagination.	IH M AE JH AH N EY SH AH N
imagine	IH M AE JH AH N
imagine,	IH M AE JH AH N
imagine.	IH M AE JH AH N
imitate	IH M AH T EY T
Imitated.	IH M AH T EY T IH D
immediate	IH M IY D IY AH T
immediately	IH M IY D IY AH T L IY
immediately.	IH M IY D IY AH T L IY
immense	IH M EH N S
immensely	IH M EH N S L IY
impatience	IH M P EY SH AH N S
impatiently	IH M P EY SH AH N T L IY
Imperial	IH M P IH R IY AH L
implicates	IH M P L IH K EY T S
importance	IH M P AO R T AH N S
importance.	IH M P AO R T AH N S
important	IH M P AO R T AH N T
impossible	IH M P AA S AH B AH L
impression	IH M P R EH SH AH N
improving	IH M P R UW V IH NG
imprudently,	IH M P R UW D AH N T L IY
impulse,	IH M P AH L S
in	IH N
In	IH N
IN	IH N
in,	IH N
in;	IH N
in!	IH N
in.	IH N
inches	IH N CH AH Z
inches(2)	IH N CH IH Z
inches,	IH N CH AH Z
inches,(2)	IH N CH IH Z
incidents	IH N S AH D AH N T S
incisive	IH N S AY S IH V
inclined	IH N K L AY N D
included	IH N K L UW D AH D
included(2)	IH N K L UW D IH D
incognito	IH N K AO G N IY T OW
incorrigible,	IH N K AA R AH JH AH B AH L
increased	IH N K R IY S T
indebted	IH N D EH T AH D
indebted(2)	IH N D EH T IH D
indeed	IH N D IY D
indeed,	IH N D IY D
Indeed,	IH N D IY D
indeed!	IH N D IY D
Indeed!	IH N D IY D
indeed?	IH N D IY D
indeed.	IH N D IY D
index,	IH N D EH K S
indicated	IH N D AH K EY T AH D
indicated(2)	IH N D AH K EY T IH D
indication	IH N D AH K EY SH AH N
indications	IH N D AH K EY SH AH N Z
indirect	IH N D ER EH K T
indiscretion.	IH N D IH S K R EH SH AH N
inextricable	IH N EH K S T R IH K AH B AH L
inflamed	IH N F L EY M D
influence	IH N F L UW AH N S
informality	IH N F ER M AE L IH T IY
information	IH N F ER M EY SH AH N
information(2)	IH N F AO R M EY SH AH N
information.	IH N F ER M EY SH AH N
information.(2)	IH N F AO R M EY SH AH N
informed	IH N F AO R M D
injured	IH N JH ER D
injuring	IH N JH ER IH NG
injustice	IH N JH AH S T IH S
ink,	IH NG K
Inner	IH N ER
inquiry,	IH N K W AY R IY
inquiry,(2)	IH N K W ER R IY
inquiry.	IH N K W AY R IY
inquiry.(2)	IH N K W ER R IY
insane.	IH N S EY N
Insensibly	IH N S EH N S AH B L IY 
inside	IH N S AY D
insist.	IH N S IH S T
inspection.	IH N S P EH K SH AH N
instance	IH N S T AH N S
instant	IH N S T AH N T
instant,	IH N S T AH N T
instead	IH N S T EH D
instinct	IH N S T IH NG K T
instructions	IH N S T R AH K SH AH N Z
instrument,	IH N S T R AH M AH N T
insult	IH N S AH L T
intelligence	IH N T EH L AH JH AH N S
intended	IH N T EH N D AH D
intended(2)	IH N T EH N D IH D
intention	IH N T EH N CH AH N
intention.	IH N T EH N CH AH N
interest	IH N T R AH S T
interest(2)	IH N T R IH S T
interest(3)	IH N T ER AH S T
interest(4)	IH N T ER IH S T
interest.	IH N T R AH S T
interest.(2)	IH N T R IH S T
interest.(3)	IH N T ER AH S T
interest.(4)	IH N T ER IH S T
interested	IH N T R AH S T AH D
interested(2)	IH N T R IH S T IH D
interested(3)	IH N T ER AH S T AH D
interested(4)	IH N T ER IH S T IH D
interested,	IH N T R AH S T AH D
interested,(2)	IH N T R IH S T IH D
interested,(3)	IH N T ER AH S T AH D
interested,(4)	IH N T ER IH S T IH D
interesting	IH N T R AH S T IH NG
interesting(2)	IH N T R IH S T IH NG
interesting(3)	IH N T ER AH S T IH NG
interesting(4)	IH N T ER IH S T IH NG
interesting.	IH N T R AH S T IH NG
interesting.(2)	IH N T R IH S T IH NG
interesting.(3)	IH N T ER AH S T IH NG
interesting.(4)	IH N T ER IH S T IH NG
interests	IH N T R AH S T S
interests(2)	IH N T R IH S T S
interests(3)	IH N T ER AH S T S
interests(4)	IH N T ER IH S T S
interfere	IH N T ER F IH R
interfere(2)	IH N ER F IH R
interfere,	IH N T ER F IH R
interfere,(2)	IH N ER F IH R
into	IH N T UW
into(2)	IH N T AH
into.	IH N T UW
into.(2)	IH N T AH
introduce	IH N T R AH D UW S
introduce(2)	IH N T R OW D UW S
introspective	IH N T R AH S P EH K T IH V
introspective(2)	IH N T R OW S P EH K T IH V
intrusion,	IH N T R UW ZH AH N
intrusions	IH N T R UW ZH AH N Z
intrusted	IH N T R AA S T IH D 
invariable	IH N V EH R IY AH B AH L
investigation	IH N V EH S T AH G EY SH AH N
inviolate.	IH N V AY AH L IH T
iodoform,	AY OW D AH F AO R M 
Irene	AY R IY N
IRENE	AY R IY N
Irene,	AY R IY N
Irene's	AY R IY N Z
Irish-setter,	AY R IH SH S EH T ER 
is	IH Z
Is	IH Z
is,	IH Z
is.	IH Z
isn't	IH Z AH N T
isn't(2)	IH Z AH N
issue	IH SH UW
it	IH T
It	IH T
it,	IH T
it!	IH T
it?	IH T
it.	IH T
It's	IH T S
its	IH T S
itself,	IH T S EH L F
itself.	IH T S EH L F
IV.	AY V IY 
IX.	AY EH K S 
Jabez	JH AA B EH Z 
Jane,	JH EY N
Jersey	JH ER Z IY
jewel-box.	JH UW AH L B AA K S 
job	JH AA B
job(2)	JH OW B
John	JH AA N
John,	JH AA N
John's	JH AA N Z
join	JH OY N
joined	JH OY N D
Jose	HH OW Z EY
journey	JH ER N IY
judicial	JH UW D IH SH AH L
jumped	JH AH M P T
just	JH AH S T
just(2)	JH IH S T
Just	JH AH S T
Just(2)	JH IH S T
keen	K IY N
keen,	K IY N
keep	K IY P
keeping.	K IY P IH NG
keeps	K IY P S
key	K IY
kind	K AY N D
kindliness	K IH N D L IY N AH S 
kindly	K AY N D L IY
Kindly	K AY N D L IY
kindness	K AY N D N AH S
King	K IH NG
King;	K IH NG
King.	K IH NG
kingdom	K IH NG D AH M
kings	K IH NG Z
knee,	N IY
knew	N UW
knew(2)	N Y UW
knot	N AA T
know	N OW
know,	N OW
know?	N OW
know.	N OW
knowing	N OW IH NG
knows	N OW Z
Kramm,	K R AE M
Kramm.	K R AE M
La	L AA
labour,	L EY B AW R
labour,(2)	L EY B ER
labour.	L EY B AW R
labour.(2)	L EY B ER
lady	L EY D IY
lady,	L EY D IY
lady;	L EY D IY
lady's	L EY D IY Z
laid	L EY D
lamps	L AE M P S
landau	L AE N D AW
landau,	L AE N D AW
landlady	L AE N D L EY D IY
lane	L EY N
Langham	L AE NG HH AE M
Langham(2)	L AE NG AH M
Language:	L AE NG G W AH JH
Language:(2)	L AE NG G W IH JH
languid,	L AE NG G W AH D
large	L AA R JH
Large	L AA R JH
larger	L AA R JH ER
last	L AE S T
last(2)	L AO S T
last(3)	L AE S
late	L EY T
late.	L EY T
lately,	L EY T L IY
lately.	L EY T L IY
later	L EY T ER
latter,	L AE T ER
laughed	L AE F T
laughed.	L AE F T
laughing	L AE F IH NG
laughing.	L AE F IH NG
law?	L AO
law?(2)	L AA
lawyer	L AO Y ER
lawyer(2)	L OY ER
lawyer.	L AO Y ER
lawyer.(2)	L OY ER
lay	L EY
lead	L EH D
lead(2)	L IY D
League	L IY G
LEAGUE	L IY G
League,	L IY G
LEAGUE:	L IY G
League.	L IY G
learn	L ER N
least	L IY S T
least.	L IY S T
leather	L EH DH ER
leave	L IY V
leave,	L IY V
leaving,	L IY V IH NG
Lebanon,	L EH B AH N AH N
led	L EH D
left	L EH F T
left.	L EH F T
legal	L IY G AH L
legal.	L IY G AH L
legs	L EH G Z
lemon,	L EH M AH N
length	L EH NG K TH
length(2)	L EH NG TH
lengthened	L EH NG TH AH N D
lengthened(2)	L EH NG K TH AH N D
lengths	L EH NG K TH S
lengths(2)	L EH NG TH S
lengthy	L EH NG TH IY
lenses,	L EH N Z AH Z
lenses,(2)	L EH N Z IH Z
lent	L EH N T
less	L EH S
let	L EH T
Let	L EH T
letter	L EH T ER
letter.	L EH T ER
letters	L EH T ER Z
letters,	L EH T ER Z
level	L EH V AH L
level?	L EH V AH L
liberty	L IH B ER T IY
License	L AY S AH N S
license,	L AY S AH N S
lie	L AY
life	L AY F
life,	L AY F
life.	L AY F
light	L AY T
light.	L AY T
lighted	L AY T AH D
lighted(2)	L AY T IH D
lighting	L AY T IH NG
lights	L AY T S
like	L AY K
likely	L AY K L IY
likely.	L AY K L IY
limbs	L IH M Z
limp	L IH M P
line	L AY N
lined	L AY N D
Lip	L IH P
lip,	L IH P
lips.	L IH P S
listen	L IH S AH N
listened	L IH S AH N D
lit	L IH T
lit,	L IH T
literature	L IH T ER AH CH ER
little	L IH T AH L
live	L AY V
live(2)	L IH V
lived	L AY V D
lived(2)	L IH V D
liver,	L IH V ER
lives	L IH V Z
lives(2)	L AY V Z
Living	L IH V IH NG
living.	L IH V IH NG
loafer,	L OW F ER
loafing	L OW F IH NG 
loathed	L OW DH D
locality	L OW K AE L AH T IY
lock	L AA K
locked	L AA K T
Lodge	L AA JH
Lodge,	L AA JH
Lodge.	L AA JH
lodgings	L AA JH IH NG Z
London	L AH N D AH N
Londoners,	L AH N D AH N ER Z
long	L AO NG
long,	L AO NG
look	L UH K
look?	L UH K
look.	L UH K
looked	L UH K T
looking	L UH K IH NG
Lord,	L AO R D
lose	L UW Z
lose,	L UW Z
loss	L AO S
lost	L AO S T
lost.	L AO S T
Lothman	L AA TH M AH N 
loud	L AW D
lounged	L AW N JH D 
loungers	L AW NG G ER Z 
loungers,	L AW NG G ER Z 
lounging	L AW N JH IH NG
love	L AH V
loved	L AH V D
lovely	L AH V L IY
lover	L AH V ER
loves	L AH V Z
low	L OW
lower	L OW ER
lucky	L AH K IY
luggage	L AH G AH JH
luggage(2)	L AH G IH JH
lying	L AY IH NG
machine	M AH SH IY N
mad	M AE D
Madame,	M AE D AH M
Madame,(2)	M AH D AE M
made	M EY D
made!	M EY D
made.	M EY D
Mademoiselle's	M AE D AH M AH Z EH L Z 
magnifico,	M AE G N AH F AH K OW 
maid	M EY D
main	M EY N
maintenance.	M EY N T AH N AH N S
maintenance.(2)	M EY N T N AH N S
Majesty	M AE JH AH S T IY
Majesty,	M AE JH AH S T IY
Majesty.	M AE JH AH S T IY
Majesty's	M AE JH AH S T IY Z
make	M EY K
maker,	M EY K ER
makes	M EY K S
making	M EY K IH NG
male	M EY L
Male	M EY L
malignant	M AH L IH G N AH N T
man	M AE N
Man	M AE N
man,	M AE N
man.	M AE N
managed	M AE N AH JH D
managed(2)	M AE N IH JH D
manager	M AE N AH JH ER
manager(2)	M AE N IH JH ER
manager.	M AE N AH JH ER
manager.(2)	M AE N IH JH ER
manner	M AE N ER
manner,	M AE N ER
manual	M AE N Y UW AH L
many	M EH N IY
many?	M EH N IY
March,	M AA R CH
mark	M AA R K
marked	M AA R K T
market	M AA R K AH T
market(2)	M AA R K IH T
marks	M AA R K S
marm?	M AA R M 
marriage	M EH R IH JH
marriage?	M EH R IH JH
married	M EH R IY D
married,	M EH R IY D
Married!	M EH R IY D
married.	M EH R IY D
marry	M EH R IY
Mary	M EH R IY
mask	M AE S K
mask,	M AE S K
mask.	M AE S K
master	M AE S T ER
masterly	M AE S T ER L IY
matter	M AE T ER
matter,	M AE T ER
matter.	M AE T ER
matters	M AE T ER Z
matters.	M AE T ER Z
may	M EY
May	M EY
may.	M EY
me	M IY
me,	M IY
me;	M IY
me!	M IY
me?	M IY
me.	M IY
mean	M IY N
mean?	M IY N
means?	M IY N Z
measures	M EH ZH ER Z
medical	M EH D AH K AH L
medical(2)	M EH D IH K AH L
meet	M IY T
member	M EH M B ER
memory	M EH M ER IY
memory.	M EH M ER IY
men	M EH N
men,	M EH N
men;	M EH N
Men?	M EH N
men.	M EH N
Men.	M EH N
men's	M EH N Z
menaced.	M EH N AH S T
menaced.(2)	M EH N IH S T
Menendez	M EH N EH N D EH Z
mental	M EH N T AH L
mention	M EH N SH AH N
merely	M IH R L IY
merry	M EH R IY
mess,	M EH S
met.	M EH T
metal	M EH T AH L
methods	M EH TH AH D Z
mews	M UW Z 
midnight	M IH D N AY T
might	M AY T
millionaire,	M IH L Y AH N EH R
millions	M IH L Y AH N Z
mind	M AY N D
mind,	M AY N D
mind.	M AY N D
mine,	M AY N
mine.	M AY N
minutes	M IH N AH T S
minutes,	M IH N AH T S
minutes!	M IH N AH T S
minutes.	M IH N AH T S
miss	M IH S
Miss	M IH S
mission	M IH SH AH N
mistake	M IH S T EY K
mistaken,	M IH S T EY K AH N
Mister	M IH S T ER
mistress	M IH S T R AH S
mistress?	M IH S T R AH S
moist	M OY S T
moment	M OW M AH N T
moment,	M OW M AH N T
moment.	M OW M AH N T
Monday,	M AH N D IY
Monday,(2)	M AH N D EY
Monday.	M AH N D IY
Monday.(2)	M AH N D EY
money	M AH N IY
money?	M AH N IY
money.	M AH N IY
Monica	M AA N IH K AH
Monica,	M AA N IH K AH
monogram,	M AA N AH G R AE M
monograph	M AA N AH G R AE F
months	M AH N TH S
mood	M UW D
moods.	M UW D Z
moody	M UW D IY
mopping	M AA P IH NG
more	M AO R
more,	M AO R
more.	M AO R
morning	M AO R N IH NG
Morning	M AO R N IH NG
morning,	M AO R N IH NG
morning.	M AO R N IH NG
mornings.	M AO R N IH NG Z
most	M OW S T
most(2)	M OW S
most.	M OW S T
most.(2)	M OW S
mostly	M OW S T L IY
mostly(2)	M OW S L IY
motion	M OW SH AH N
motioned	M OW SH AH N D
motives	M OW T IH V Z
moustached	M S T AE CH T 
mouth	M AW TH
mouths.	M AW DH Z
Mr.	M IH S T ER
MR.	M IH S T ER
Mrs.	M IH S IH Z
much	M AH CH
much,	M AH CH
much.	M AH CH
mud	M AH D
mumbling	M AH M B AH L IH NG
mumbling(2)	M AH M B L IH NG
murder,	M ER D ER
murmured	M ER M ER D
muscles	M AH S AH L Z
must	M AH S T
my	M AY
My	M AY
MY	M AY
myself	M AY S EH L F
myself,	M AY S EH L F
myself.	M AY S EH L F
mysteries	M IH S T ER IY Z
mysteries.	M IH S T ER IY Z
Mystery	M IH S T ER IY
mystery,	M IH S T ER IY
name	N EY M
name,	N EY M
name.	N EY M
named	N EY M D
narrative	N AE R AH T IH V
narrative(2)	N EH R AH T IH V
narrative.	N AE R AH T IH V
narrative.(2)	N EH R AH T IH V
narrowly	N EH R OW L IY
naturally	N AE CH ER AH L IY
naturally(2)	N AE CH R AH L IY
nature	N EY CH ER
nature.	N EY CH ER
near	N IH R
nearly	N IH R L IY
neat	N IY T
necessitate	N AH S EH S AH T EY T
neck	N EH K
n√©e	EH N IY 
need	N IY D
neighbourhood	N EY B AO R HH UH D 
neighbourhood,	N EY B AO R HH UH D 
neither	N IY DH ER
neither(2)	N AY DH ER
neither.	N IY DH ER
neither.(2)	N AY DH ER
nerves	N ER V Z
nervous	N ER V AH S
nest	N EH S T
neutral,	N UW T R AH L
neutral?	N UW T R AH L
never	N EH V ER
Never	N EH V ER
never!	N EH V ER
Never.	N EH V ER
new	N UW
new(2)	N Y UW
New	N UW
New(2)	N Y UW
news	N UW Z
news(2)	N Y UW Z
news.	N UW Z
news.(2)	N Y UW Z
newspaper	N UW Z P EY P ER
next	N EH K S T
next(2)	N EH K S
nice	N AY S
nice(2)	N IY S
nicely,	N AY S L IY
night	N AY T
night,	N AY T
nitrate	N AY T R EY T
no	N OW
No	N OW
no,	N OW
No,	N OW
noble	N OW B AH L
Noble	N OW B AH L
nobleman.	N OW B AH L M AH N
nod	N AA D
nominal	N AA M AH N AH L
nominal?	N AA M AH N AH L
nominal.	N AA M AH N AH L
Nonconformist	N AA N K AH N F AO R M IH S T
none	N AH N
none,	N AH N
none.	N AH N
None.	N AH N
nor	N AO R
Nor	N AO R
north,	N AO R TH
Norton	N AO R T AH N
Norton,	N AO R T AH N
NORTON,	N AO R T AH N
Norton.	N AO R T AH N
not	N AA T
Not	N AA T
not,	N AA T
not.	N AA T
note	N OW T
note-book	N OW T B UH K 
note-paper	N OW T P EY P ER 
note-paper.	N OW T P EY P ER 
note,	N OW T
note?	N OW T
notes,	N OW T S
nothing	N AH TH IH NG
Nothing	N AH TH IH NG
nothing,	N AH TH IH NG
nothing.	N AH TH IH NG
notice,	N OW T AH S
notice,(2)	N OW T IH S
noticed	N OW T AH S T
noting	N OW T IH NG
November	N OW V EH M B ER
now	N AW
Now	N AW
now,	N AW
Now,	N AW
now?	N AW
now.	N AW
number	N AH M B ER
numerous	N UW M ER AH S
nurse-girl,	N ER S G ER L 
o'clock	AH K L AA K
o'clock,	AH K L AA K
obese,	OW B IY S
obese,(2)	AH B IY S
object	AA B JH EH K T
object(2)	AH B JH EH K T
object,	AA B JH EH K T
object,(2)	AH B JH EH K T
object.	AA B JH EH K T
object.(2)	AH B JH EH K T
objection	AH B JH EH K SH AH N
obliged	AH B L AY JH D
obliging	AH B L AY JH IH NG
observation	AA B Z ER V EY SH AH N
observe.	AH B Z ER V
observed	AH B Z ER V D
observed.	AH B Z ER V D
observer	AH B Z ER V ER
observing	AH B Z ER V IH NG
obstinacy.	AA B S T AH N AH S IY
obvious	AA B V IY AH S
Obviously	AA B V IY AH S L IY
occasion.	AH K EY ZH AH N
occasionally	AH K EY ZH AH N AH L IY
occasionally(2)	AH K EY ZH N AH L IY
occasionally(3)	AH K EY ZH AH N L IY
occasionally,	AH K EY ZH AH N AH L IY
occasionally,(2)	AH K EY ZH N AH L IY
occasionally,(3)	AH K EY ZH AH N L IY
occupant.	AA K Y AH P AH N T
occupation,	AA K Y AH P EY SH AH N
occupations.	AA K Y AH P EY SH AH N Z
occupied	AA K Y AH P AY D
occur	AH K ER
occur.	AH K ER
Odessa	OW D EH S AH
of	AH V
Of	AH V
OF	AH V
of.	AH V
off	AO F
office	AO F AH S
office,	AO F AH S
office.	AO F AH S
offices	AO F AH S AH Z
offices(2)	AO F AH S IH Z
official	AH F IH SH AH L
often	AO F AH N
often(2)	AO F T AH N
often?	AO F AH N
often?(2)	AO F T AH N
oh,	OW
Oh,	OW
old	OW L D
old.	OW L D
ominous.	AA M AH N AH S
Omne	AA M N 
on	AA N
on(2)	AO N
On	AA N
On(2)	AO N
once	W AH N S
Once	W AH N S
once;	W AH N S
one	W AH N
one(2)	HH W AH N
One	W AH N
One(2)	HH W AH N
one,	W AH N
one,(2)	HH W AH N
one;	W AH N
one;(2)	HH W AH N
one's	W AH N Z
online	AO N L AY N
only	OW N L IY
open	OW P AH N
open,	OW P AH N
open.	OW P AH N
opened	OW P AH N D
opened,	OW P AH N D
opening	OW P AH N IH NG
Opera	AA P R AH
operatic	AA P ER AE T IH K
opulence	AA P Y AH L AH N S
or	AO R
or(2)	ER
orange	AO R AH N JH
orange(2)	AO R IH N JH
Orange	AO R AH N JH
Orange(2)	AO R IH N JH
orange,	AO R AH N JH
orange,(2)	AO R IH N JH
order	AO R D ER
order,	AO R D ER
ordered	AO R D ER D
orders	AO R D ER Z
ordinary	AO R D AH N EH R IY
Ormstein,	AO R M S T AY N 
ornament.	AO R N AH M AH N T
ostlers	AA S T L ER Z 
ostlers,	AA S T L ER Z 
other	AH DH ER
other,	AH DH ER
other.	AH DH ER
others	AH DH ER Z
others,	AH DH ER Z
otherwise	AH DH ER W AY Z
ought	AO T
our	AW ER
our(2)	AW R
our(3)	AA R
Our	AW ER
Our(2)	AW R
Our(3)	AA R
ourselves	AW ER S EH L V Z
ourselves(2)	AA R S EH L V Z
out	AW T
out,	AW T
out?	AW T
out.	AW T
outlined	AW T L AY N D
outside	AW T S AY D
outside,	AW T S AY D
over	OW V ER
over-clean	OW V ER K L IY N 
over-good	OW V ER G UH D 
over-precipitance	OW V ER P R IH S IH P AH T AH N S 
overcoat	OW V ER K OW T
overpowering	OW V ER P AW R IH NG
own	OW N
own.	OW N
P,	P IY
paced	P EY S T
pacing	P EY S IH NG
packet.	P AE K AH T
packet.(2)	P AE K IH T
paid	P EY D
pain.	P EY N
paint	P EY N T
paint.	P EY N T
pair	P EH R
pair,	P EH R
palm	P AA M
palm(2)	P AA L M
panel	P AE N AH L
paper	P EY P ER
paper-mills.	P EY P ER M IH L Z 
paper,	P EY P ER
paper.	P EY P ER
papers	P EY P ER Z
papers?	P EY P ER Z
Papier.	P EY P Y ER
paragraphs	P AE R AH G R AE F S
paragraphs(2)	P EH R AH G R AE F S
parallel	P EH R AH L EH L
park	P AA R K
part	P AA R T
part.	P AA R T
particularly	P AA R T IH K Y AH L ER L IY
particularly(2)	P ER T IH K Y AH L ER L IY
particularly,	P AA R T IH K Y AH L ER L IY
particularly,(2)	P ER T IH K Y AH L ER L IY
particulars.	P ER T IH K Y AH L ER Z
partner	P AA R T N ER
pass	P AE S
passage	P AE S AH JH
passage(2)	P AE S IH JH
passage,	P AE S AH JH
passage,(2)	P AE S IH JH
passed	P AE S T
passing	P AE S IH NG
passions,	P AE SH AH N Z
past	P AE S T
patch	P AE CH
patient	P EY SH AH N T
paused	P AO Z D
pavement	P EY V M AH N T
pawnbroker's	P AO N B R OW K ER Z 
pay	P EY
pay-day;	P EY D EY 
pay?	P EY
pay.	P EY
peace.	P IY S
peculiar	P AH K Y UW L Y ER
peculiar(2)	P IH K Y UW L Y ER
Peculiar	P AH K Y UW L Y ER
Peculiar(2)	P IH K Y UW L Y ER
peculiarly	P IH K Y UW L Y ER L IY
peering	P IY R IH NG
Pennsylvania,	P EH N S AH L V EY N Y AH
penny	P EH N IY
pens,	P EH N Z
pensioners	P EH N SH AH N ER Z
people	P IY P AH L
people,	P IY P AH L
people.	P IY P AH L
perceive	P ER S IY V
perch	P ER CH
perfect	P ER F EH K T
perfect(2)	P ER F IH K T
perfectly	P ER F AH K T L IY
perfectly(2)	P ER F AH K L IY
perhaps	P ER HH AE P S
perhaps,	P ER HH AE P S
Perhaps,	P ER HH AE P S
person	P ER S AH N
person,	P ER S AH N
person.	P ER S AH N
persuaded	P ER S W EY D AH D
persuaded(2)	P ER S W EY D IH D
photograph	F OW T AH G R AE F
photograph,	F OW T AH G R AE F
photograph!	F OW T AH G R AE F
photograph?	F OW T AH G R AE F
photograph.	F OW T AH G R AE F
photography.	F AH T AA G R AH F IY
pictured	P IH K CH ER D
pictures.	P IH K CH ER Z
pierced	P IH R S T
piling	P AY L IH NG
pinch	P IH N CH
pink	P IH NG K
pink-tinted	P IH NG K T IH N T IH D 
Pips	P IH P S
piteous	P IH T IY AH S 
pity	P IH T IY
place	P L EY S
placed	P L EY S T
plainly,	P L EY N L IY
plan	P L AE N
plan.	P L AE N
planet.	P L AE N AH T
planked	P L AE NG K T 
plans	P L AE N Z
planted	P L AE N T AH D
planted(2)	P L AE N T IH D
planted(3)	P L AE N AH D
planted(4)	P L AE N IH D
play.	P L EY
playing,	P L EY IH NG
please!	P L IY Z
pleased	P L IY Z D
pleasure	P L EH ZH ER
plumber's	P L AA M ER Z 
plunged	P L AH N JH D
plunging	P L AH N JH IH NG
pocket	P AA K AH T
pocket.	P AA K AH T
pockets	P AA K AH T S
pockets,	P AA K AH T S
point	P OY N T
point,	P OY N T
point.	P OY N T
police.	P AH L IY S
political	P AH L IH T AH K AH L
political(2)	P AH L IH T IH K AH L
pompous,	P AA M P AH S
Pooh,	P UW
pooh!	P UW
poor	P UH R
Pope's	P OW P S
portly	P AO R T L IY
position	P AH Z IH SH AH N
position.	P AH Z IH SH AH N
positive	P AA Z AH T IH V
possess;	P AH Z EH S
possibility	P AA S AH B IH L AH T IY
possibility.	P AA S AH B IH L AH T IY
possible	P AA S AH B AH L
possible.	P AA S AH B AH L
possibly	P AA S AH B L IY
post	P OW S T
post,	P OW S T
Posted:	P OW S T IH D
Posting	P OW S T IH NG
pounds	P AW N D Z
pounds(2)	P AW N Z
pounds.	P AW N D Z
pounds.(2)	P AW N Z
power.	P AW ER
powers	P AW ER Z
powers.	P AW ER Z
practically	P R AE K T AH K L IY
practically(2)	P R AE K T AH K AH L IY
practice	P R AE K T AH S
practice(2)	P R AE K T IH S
practice,	P R AE K T AH S
practice,(2)	P R AE K T IH S
practice.	P R AE K T AH S
practice.(2)	P R AE K T IH S
Prague	P R AA G
pray	P R EY
Pray	P R EY
precaution	P R IY K AO SH AH N
precaution.	P R IY K AO SH AH N
preceding	P R IY S IY D IH NG
precious	P R EH SH AH S
precise	P R IH S AY S
precise(2)	P R IY S AY S
precisely	P R IH S AY S L IY
precisely(2)	P R IY S AY S L IY
Precisely	P R IH S AY S L IY
Precisely(2)	P R IY S AY S L IY
Precisely.	P R IH S AY S L IY
Precisely.(2)	P R IY S AY S L IY
predominates	P R IH D AA M AH N EY T S
prefer	P R AH F ER
prefer(2)	P R IH F ER
prefer(3)	P R IY F ER
prefers	P R AH F ER Z
prefers(2)	P R IH F ER Z
prefers(3)	P R IY F ER Z
prepare	P R IY P EH R
preposterous	P R IH P AA S T ER AH S
preposterous(2)	P R IH P AA S T R AH S
present	P R EH Z AH N T
present(2)	P R IY Z EH N T
present(3)	P ER Z EH N T
present?	P R EH Z AH N T
present?(2)	P R IY Z EH N T
present?(3)	P ER Z EH N T
present.	P R EH Z AH N T
present.(2)	P R IY Z EH N T
present.(3)	P ER Z EH N T
presented	P R IY Z EH N T AH D
presented(2)	P ER Z EH N T AH D
presented(3)	P R IY Z EH N AH D
presented(4)	P ER Z EH N AH D
Presently	P R EH Z AH N T L IY
preserve	P R AH Z ER V
preserve(2)	P R IH Z ER V
preserve(3)	P R IY Z ER V
press,	P R EH S
press.	P R EH S
presumably	P R AH Z UW M AH B L IY
presumably(2)	P R IH Z UW M AH B L IY
presumably(3)	P R IY Z UW M AH B L IY
presume?	P R IH Z UW M
pretty	P R IH T IY
preventing	P R IH V EH N T IH NG
preventing(2)	P R IY V EH N T IH NG
preventing(3)	P R IH V EH N IH NG
preventing(4)	P R IY V EH N IH NG
price.	P R AY S
prick	P R IH K
pride	P R AY D
Prima	P R IY M AH
Prince	P R IH N S
princess.	P R IH N S EH S
principal	P R IH N S AH P AH L
principles	P R IH N S AH P AH L Z
private	P R AY V AH T
pro	P R OW
probable	P R AA B AH B AH L
probably	P R AA B AH B L IY
probably(2)	P R AA B L IY
problem	P R AA B L AH M
problem,	P R AA B L AH M
problem.	P R AA B L AH M
problems,	P R AA B L AH M Z
proceedings	P R OW S IY D IH NG Z
proceedings(2)	P R AH S IY D IH NG Z
process	P R AA S EH S
process(2)	P R AO S EH S
process.	P R AA S EH S
process.(2)	P R AO S EH S
processes.	P R AA S EH S AH Z
proclaimed.	P R OW K L EY M D
produce	P R AH D UW S
produce(2)	P R OW D UW S
Produced	P R AH D UW S T
profession.	P R AH F EH SH AH N
progress.	P R AA G R EH S
progress.(2)	P R AH G R EH S
progress.(3)	P R OW G R EH S
Project	P R AA JH EH K T
Project(2)	P R AH JH EH K T
PROJECT	P R AA JH EH K T
PROJECT(2)	P R AH JH EH K T
promise,	P R AA M AH S
promises	P R AA M AH S AH Z
prompt	P R AA M P T
prompt,	P R AA M P T
prompted	P R AA M P T AH D
prompted(2)	P R AA M P T IH D
pronounce	P R AH N AW N S
propagation	P R AA P AH G EY SH AH N
propose	P R AH P OW Z
proposition	P R AA P AH Z IH SH AH N
protect	P R AH T EH K T
protect(2)	P ER T EH K T
prove	P R UW V
provide	P R AH V AY D
provided,	P R AH V AY D AH D
provided,(2)	P R AH V AY D IH D
providing	P R AH V AY D IH NG
provinces	P R AA V AH N S AH Z
Pshaw!	P IY EH S EY CH EY D AA B AH L Y UW 
publicly	P AH B L IH K L IY
puffed	P AH F T
pull	P UH L
pulled	P UH L D
purely	P Y UH R L IY
purpose	P ER P AH S
purposes,	P ER P AH S AH Z
purposes,(2)	P ER P AH S IH Z
purse	P ER S
pursued	P ER S UW D
pushed	P UH SH T
put	P UH T
putting	P AH T IH NG
putting(2)	P UH T IH NG
Putting	P AH T IH NG
Putting(2)	P UH T IH NG
quarrel	K W AO R AH L
quarter	K W AO R T ER
quarter(2)	K AO R T ER
quarters	K W AO R T ER Z
queen	K W IY N
queen?	K W IY N
quench	K W EH N CH
quest	K W EH S T
question	K W EH S CH AH N
question(2)	K W EH SH AH N
question,	K W EH S CH AH N
question,(2)	K W EH SH AH N
questionable	K W EH S CH AH N AH B AH L
questioning	K W EH S CH AH N IH NG
quick	K W IH K
quick,	K W IH K
quiet	K W AY AH T
quietly,	K W AY AH T L IY
quill-pen,	K W IH L P EH N 
quite	K W AY T
Quite	K W AY T
rabbi	R AE B AY
rabbit	R AE B AH T
rabbit(2)	R AE B IH T
raise	R EY Z
raised	R EY Z D
ran	R AE N
rang	R AE NG
ransacked	R AE N S AE K T
rather	R AE DH ER
rather(2)	R AH DH ER
Rather	R AE DH ER
Rather(2)	R AH DH ER
rather,	R AE DH ER
rather,(2)	R AH DH ER
rather.	R AE DH ER
rather.(2)	R AH DH ER
rattled	R AE T AH L D
re-use	R EY Y UW S 
reach	R IY CH
reached	R IY CH T
reaches	R IY CH AH Z
reaches(2)	R IY CH IH Z
read	R EH D
read(2)	R IY D
Read	R EH D
Read(2)	R IY D
readers	R IY D ER Z
ready	R EH D IY
real	R IY L
really	R IH L IY
really(2)	R IY L IY
really!	R IH L IY
really!(2)	R IY L IY
reason	R IY Z AH N
reasoned	R IY Z AH N D
reasoner	R IY Z AH N ER
reasoner,	R IY Z AH N ER
reasoning	R IY Z AH N IH NG
reasoning,	R IY Z AH N IH NG
reasons,	R IY Z AH N Z
recall	R IY K AO L
recall(2)	R IH K AO L
receipt	R IH S IY T
receipt(2)	R IY S IY T
received	R AH S IY V D
received(2)	R IH S IY V D
received(3)	R IY S IY V D
received.	R AH S IY V D
received.(2)	R IH S IY V D
received.(3)	R IY S IY V D
recent	R IY S AH N T
recess	R IH S EH S
recess(2)	R IY S EH S
recommence	R EH K AH M EH N S 
recorded,	R AH K AO R D AH D
recorded,(2)	R IH K AO R D IH D
recovered.	R AH K AH V ER D
recovered.(2)	R IH K AH V ER D
red	R EH D
red-head	R EH D HH EH D 
red-headed	R EH D HH EH D AH D 
Red-headed	R EH D HH EH D AH D 
RED-HEADED	R EH D HH EH D AH D 
red-headed,	R EH D HH EH D AH D 
red-heads	R EH D HH EH D Z 
red,	R EH D
red.	R EH D
redder	R EH D ER
refers	R AH F ER Z
refers(2)	R IH F ER Z
refreshed	R IY F R EH SH T
refuse.	R AH F Y UW Z
refuse.(2)	R EH F Y UW Z
refuse.(3)	R IH F Y UW Z
refused	R AH F Y UW Z D
refused(2)	R IH F Y UW Z D
regain	R IH G EY N
Regent	R IY JH AH N T
reigning	R EY N IH NG
rejoiced	R IH JH OY S T
rejoin	R IY JH OY N
relapsed	R IY L AE P S T
relapsing	R IH L AE P S IH NG
relation	R IY L EY SH AH N
released	R IY L IY S T
relish	R EH L IH SH
rely	R IH L AY
rely(2)	R IY L AY
remain	R IH M EY N
remain(2)	R IY M EY N
remain,	R IH M EY N
remain,(2)	R IY M EY N
remained	R IH M EY N D
remained(2)	R IY M EY N D
remains,	R IH M EY N Z
remains,(2)	R IY M EY N Z
remark	R IH M AA R K
remark(2)	R IY M AA R K
remarkable	R IH M AA R K AH B AH L
remarkable(2)	R IY M AA R K AH B AH L
Remarkable	R IH M AA R K AH B AH L
Remarkable(2)	R IY M AA R K AH B AH L
remarkable,	R IH M AA R K AH B AH L
remarkable,(2)	R IY M AA R K AH B AH L
remarkably	R IH M AA R K AH B L IY
remarkably(2)	R IY M AA R K AH B L IY
remarked	R IH M AA R K T
remarked(2)	R IY M AA R K T
remarked,	R IH M AA R K T
remarked,(2)	R IY M AA R K T
remarked.	R IH M AA R K T
remarked.(2)	R IY M AA R K T
remember	R IH M EH M B ER
remember(2)	R IY M EH M B ER
remove	R IY M UW V
reopened	R IY OW P AH N D
repeated	R IH P IY T IH D
repeated(2)	R IY P IY T AH D
repeated(3)	R IY P IY T IH D
replaced	R IY P L EY S T
reproachfully.	R IY P R OW CH F AH L IY 
reputation,	R EH P Y AH T EY SH AH N
requirement.	R IH K W AY R M AH N T
resolute	R EH Z AH L UW T
resolution	R EH Z AH L UW SH AH N
resolve	R IY Z AA L V
resolved	R IY Z AA L V D
resource	R IY S AO R S
respectable,	R IH S P EH K T AH B AH L
respectable,(2)	R IY S P EH K T AH B AH L
responded	R IH S P AA N D IH D
responded(2)	R IY S P AA N D AH D
responded(3)	R IY S P AA N D IH D
responses	R IH S P AA N S IH Z
responses(2)	R IY S P AA N S AH Z
responses(3)	R IY S P AA N S IH Z
rest	R EH S T
restrictions	R IY S T R IH K SH AH N Z
result.	R IH Z AH L T
result.(2)	R IY Z AH L T
results.	R IH Z AH L T S
results.(2)	R IY Z AH L T S
Retired	R IH T AY R D
Retired(2)	R IY T AY ER D
Retired(3)	R IY T AY R D
return.	R IH T ER N
return.(2)	R IY T ER N
returned	R IH T ER N D
returned(2)	R IY T ER N D
returned.	R IH T ER N D
returned.(2)	R IY T ER N D
returning	R IH T ER N IH NG
returning(2)	R IY T ER N IH NG
returns	R IH T ER N Z
returns(2)	R IY T ER N Z
reveal	R IH V IY L
reveal(2)	R IY V IY L
reward	R IH W AO R D
reward(2)	R IY W AO R D
rich	R IH CH
richness	R IH CH N AH S
ridiculously	R AH D IH K Y AH L AH S L IY
right	R AY T
right,	R AY T
right.	R AY T
ring	R IH NG
ringing	R IH NG IH NG
rise	R AY Z
risen	R IH Z AH N
risk	R IH S K
road,	R OW D
Road.	R OW D
rocket	R AA K AH T
rocket,	R AA K AH T
role	R OW L
roll	R OW L
rolled	R OW L D
roof	R UW F
roof(2)	R UH F
room	R UW M
room,	R UW M
room.	R UW M
rooms	R UW M Z
rose	R OW Z
rose,	R OW Z
Ross	R AA S
Ross(2)	R AO S
Ross,	R AA S
Ross,(2)	R AO S
Ross;	R AA S
Ross;(2)	R AO S
rough	R AH F
round	R AW N D
routine	R UW T IY N
row	R OW
royal	R OY AH L
rubbed	R AH B D
rubbing	R AH B IH NG
ruin	R UW AH N
ruin(2)	R UW IH N
rule,	R UW L
rules	R UW L Z
rumble	R AH M B AH L
run	R AH N
running	R AH N IH NG
runs	R AH N Z
rush	R AH SH
rushed	R AH SH T
rushing	R AH SH IH NG
Russian	R AH SH AH N
S.	EH S
safe	S EY F
safeguard	S EY F G AA R D
safely	S EY F L IY
safer	S EY F ER
said	S EH D
said,	S EH D
said:	S EH D
said.	S EH D
sake	S EY K
salary	S AE L ER IY
sally	S AE L IY
same	S EY M
sandwiched	S AE N D W IH CH T
sandwiched(2)	S AE N W IH CH T
sandwiched(3)	S AE M W IH CH T
sardonic	S AA R D AA N IH K
sat	S AE T
satisfaction	S AE T AH S F AE K SH AH N
satisfaction(2)	S AE T IH S F AE K SH AH N
satisfied,	S AE T AH S F AY D
satisfied,(2)	S AE T IH S F AY D
Saturday	S AE T ER D IY
Saturday(2)	S AE T IH D EY
savagely	S AE V IH JH L IY
save	S EY V
saved	S EY V D
saw	S AO
Saxe-Meningen,	S AE K S M AH N IH NG AH N 
say	S EY
saying	S EY IH NG
says	S EH Z
says(2)	S IH Z
says:	S EH Z
says:(2)	S IH Z
Scala,	S K AA L AH
scales	S K EY L Z
scandal	S K AE N D AH L
Scandal	S K AE N D AH L
SCANDAL	S K AE N D AH L
Scandinavia.	S K AE N D IH N EY V IY AH
Scarlet,	S K AA R L AH T
scattered	S K AE T ER D
scene	S IY N
scent	S EH N T
science	S AY AH N S
scissors-grinder	S IH Z ER Z G R AY N D ER 
scissors-grinder,	S IH Z ER Z G R AY N D ER 
scored	S K AO R D
scraped	S K R EY P T
scratch	S K R AE CH
scribbled	S K R IH B AH L D
scuffle	S K AH F AH L
seal.	S IY L
search	S ER CH
searched.	S ER CH T
searching	S ER CH IH NG
seat,	S IY T
second	S EH K AH N D
second(2)	S EH K AH N
secrecy	S IY K R AH S IY
secret	S IY K R AH T
secret(2)	S IY K R IH T
secreted	S AH K R IY T AH D
secreting.	S IY K R AH T IH NG 
secretive,	S IY K R AH T IH V
secure	S IH K Y UH R
secured	S IH K Y UH R D
see	S IY
See	S IY
see,	S IY
see!	S IY
see.	S IY
seem	S IY M
seemed	S IY M D
seems	S IY M Z
seen	S IY N
seen,	S IY N
seen.	S IY N
seized	S IY Z D
seldom	S EH L D AH M
Seldom	S EH L D AH M
self-lighting.	S EH L F L AY T IH NG 
sell.	S EH L
send	S EH N D
sensitive	S EH N S AH T IH V
sensitive(2)	S EH N S IH T IH V
sent	S EH N T
sentence	S EH N T AH N S
separated,	S EH P ER EY T AH D
separated,(2)	S EH P ER EY T IH D
sequel	S IY K W AH L
serious	S IH R IY AH S
seriously	S IH R IY AH S L IY
seriously.	S IH R IY AH S L IY
Serpentine	S ER P AH N T AY N
Serpentine-mews,	S ER P AH N T AY N M UW Z 
servant	S ER V AH N T
servant-maids	S ER V AH N T M EY D Z 
services	S ER V AH S AH Z
services(2)	S ER V IH S IH Z
services.	S ER V AH S AH Z
services.(2)	S ER V IH S IH Z
set	S EH T
settee,	S EH T IY 
settling	S EH T AH L IH NG
settling(2)	S EH T L IH NG
seven	S EH V AH N
Seven!	S EH V AH N
seven.	S EH V AH N
seventeen	S EH V AH N T IY N
several	S EH V R AH L
several(2)	S EH V ER AH L
sex.	S EH K S
shabbily	SH AE B AH AH L IY 
shabby	SH AE B IY
shade	SH EY D
shadow	SH AE D OW
shag	SH AE G
shake	SH EY K
shall	SH AE L
share	SH EH R
shared	SH EH R D
sharp	SH AA R P
she	SH IY
She	SH IY
she.	SH IY
sheet	SH IY T
sheets	SH IY T S
shelves	SH EH L V Z
shelves.	SH EH L V Z
shepherd's	SH EH P ER D Z
Sherlock	SH ER L AA K
SHERLOCK	SH ER L AA K
shiny	SH AY N IY
ship's	SH IH P S
shipwreck	SH IH P R EH K
shoe,	SH UW
shook	SH UH K
shortly	SH AO R T L IY
shot	SH AA T
should	SH UH D
shoulder	SH OW L D ER
shoulders	SH OW L D ER Z
shoulders.	SH OW L D ER Z
shouted	SH AW T AH D
shouted(2)	SH AW T IH D
shouted,	SH AW T AH D
shouted,(2)	SH AW T IH D
shouting	SH AW T IH NG
show	SH OW
showed	SH OW D
showing	SH OW IH NG
shown	SH OW N
shriek	SH R IY K
shrugged	SH R AH G D
shut	SH AH T
shutter,	SH AH T ER
shutters	SH AH T ER Z
shutting	SH AH T IH NG
sickness	S IH K N AH S
side	S AY D
side-lights	S AY D L AY T S 
side-whiskered,	S AY D W IH S K ER D 
side,	S AY D
side.	S AY D
sides	S AY D Z
sight	S AY T
Sigismond	S IH G IH Z M AH N D 
sign	S AY N
signal	S IH G N AH L
signature	S IH G N AH CH ER
signs	S AY N Z
silence	S AY L AH N S
silence,	S AY L AH N S
silhouette	S IH L AH W EH T
silk	S IH L K
silver	S IH L V ER
similar	S IH M AH L ER
simple	S IH M P AH L
simple-minded	S IH M P AH L M AY N D AH D 
simple.	S IH M P AH L
simplicity	S IH M P L IH S AH T IY
simplicity(2)	S IH M P L IH S IH T IY
simplifies	S IH M P L AH F AY Z
simplify	S IH M P L AH F AY
since	S IH N S
since.	S IH N S
single	S IH NG G AH L
sings	S IH NG Z
sings.	S IH NG Z
singular	S IH NG G Y AH L ER
SIR	S ER
sir,	S ER
sir.	S ER
Sit	S IH T
sitting	S IH T IH NG
sitting-room	S IH T IH NG R UW M 
sitting-room,	S IH T IH NG R UW M 
sitting-room.	S IH T IH NG R UW M 
situation,	S IH CH UW EY SH AH N
situation.	S IH CH UW EY SH AH N
six	S IH K S
size	S AY Z
size.	S AY Z
slashed	S L AE SH T
slavey.	S L EY V IY 
sleeves	S L IY V Z
slept	S L EH P T
sliding	S L AY D IH NG
slight	S L AY T
slight,	S L AY T
slim	S L IH M
slipped	S L IH P T
Slipping	S L IH P IH NG
slow	S L OW
slow.	S L OW
slowly	S L OW L IY
Slowly	S L OW L IY
small	S M AO L
smaller	S M AO L ER
smart	S M AA R T
smarter	S M AA R T ER
smelling	S M EH L IH NG
smile	S M AY L
smile,	S M AY L
smoke	S M OW K
smoke-rocket	S M OW K R AA K AH T 
smoke-rocket,	S M OW K R AA K AH T 
smoking	S M OW K IH NG
smooth	S M UW DH
snake	S N EY K
Snapping	S N AE P IH NG
sneer.	S N IH R
snuff,	S N AH F
snuff.	S N AH F
so	S OW
So	S OW
so,	S OW
so;	S OW
so!	S OW
so.	S OW
society	S AH S AY AH T IY
sofa.	S OW F AH
softer	S AA F T ER
softer(2)	S AO F T ER
sole	S OW L
solemnly	S AO L AH M L IY
some	S AH M
Some	S AH M
someone	S AH M W AH N
something	S AH M TH IH NG
somewhat	S AH M W AH T
somewhat(2)	S AH M HH W AH T
soon	S UW N
sooner	S UW N ER
sorry	S AA R IY
sort	S AO R T
sort,	S AO R T
soul	S OW L
soul,	S OW L
sound	S AW N D
sound,	S AW N D
sounded	S AW N D AH D
sounded(2)	S AW N D IH D
south,	S AW TH
sovereign	S AA V R AH N
sovereign,	S AA V R AH N
sovereigns	S AA V R AH N Z
spare	S P EH R
sparkled,	S P AA R K AH L D
Spaulding	S P AO L D IH NG
Spaulding,	S P AO L D IH NG
Spaulding.	S P AO L D IH NG
speak	S P IY K
speaks	S P IY K S
specialist	S P EH SH AH L AH S T
specialist(2)	S P EH SH AH L IH S T
specimen	S P EH S AH M AH N
Speckled	S P EH K AH L D
spectacle.	S P EH K T AH K AH L
spectators,	S P EH K T EY T ER Z
spinster,	S P IH N S T ER
spirit	S P IH R AH T
spirit(2)	S P IH R IH T
spirits	S P IH R AH T S
spirits(2)	S P IH R IH T S
spirits.	S P IH R AH T S
spirits.(2)	S P IH R IH T S
splendid	S P L EH N D AH D
splendid(2)	S P L EH N D IH D
spoke	S P OW K
spoken	S P OW K AH N
spoken,	S P OW K AH N
sprang	S P R AE NG
spread	S P R EH D
square	S K W EH R
Square,	S K W EH R
St.	S T R IY T
St.(2)	S EY N T
staff-commander	S T AE F K AH M AE N D ER 
stage	S T EY JH
staggered	S T AE G ER D
staining	S T EY N IH NG
stair,	S T EH R
stairs	S T EH R Z
stairs,	S T EH R Z
standing	S T AE N D IH NG
stands	S T AE N D Z
stared	S T EH R D
staring	S T EH R IH NG
START	S T AA R T
started	S T AA R T AH D
started(2)	S T AA R T IH D
startled	S T AA R T AH L D
state	S T EY T
statement.	S T EY T M AH N T
station	S T EY SH AH N
station!	S T EY SH AH N
stay	S T EY
Stay	S T EY
stay-at-home	S T EY AE T HH OW M 
stay,	S T EY
steaming	S T IY M IH NG
steel.	S T IY L
step	S T EH P
step,	S T EH P
stepped	S T EH P T
steps	S T EH P S
steps,	S T EH P S
steps;	S T EH P S
steps.	S T EH P S
stethoscope,	S T EH TH AH S K OW P
sticking	S T IH K IH NG
sticks.	S T IH K S
stiff.	S T IH F
still	S T IH L
still,	S T IH L
Still,	S T IH L
Stolen,	S T OW L AH N
Stolen.	S T OW L AH N
stood	S T UH D
stopped	S T AA P T
stories.	S T AO R IY Z
story	S T AO R IY
story.	S T AO R IY
stout	S T AW T
stout,	S T AW T
straight	S T R EY T
strange	S T R EY N JH
strangest	S T R EY N JH IH S T
straw,	S T R AO
stream	S T R IY M
street	S T R IY T
Street	S T R IY T
street,	S T R IY T
Street,	S T R IY T
street.	S T R IY T
Street.	S T R IY T
streets	S T R IY T S
stretch	S T R EH CH
stretched	S T R EH CH T
strict	S T R IH K T
strikes	S T R AY K S
strong	S T R AO NG
strongly	S T R AO NG L IY
struck	S T R AH K
struck,	S T R AH K
struggling	S T R AH G AH L IH NG
struggling(2)	S T R AH G L IH NG
study	S T AH D IY
Study	S T AH D IY
subject	S AH B JH EH K T
subject(2)	S AH B JH IH K T
subject.	S AH B JH EH K T
subject.(2)	S AH B JH IH K T
substitution	S AH B S T IH T UW SH AH N
subtle	S AH T AH L
success	S AH K S EH S
success.	S AH K S EH S
successful	S AH K S EH S F AH L
successful.	S AH K S EH S F AH L
successfully	S AH K S EH S F AH L IY
successive	S AH K S EH S IH V
succinct	S AH K S IH NG K T
such	S AH CH
Such	S AH CH
suddenly	S AH D AH N L IY
Suddenly,	S AH D AH N L IY
suffer	S AH F ER
sufficient	S AH F IH SH AH N T
suggested	S AH G JH EH S T AH D
suggested(2)	S AH G JH EH S T IH D
suggestive	S AH G JH EH S T IH V
suit	S UW T
suited	S UW T AH D
suited(2)	S UW T IH D
suits	S UW T S
sum	S AH M
summons	S AH M AH N Z
sunk	S AH NG K
superb	S UH P ER B
superscribed	S UW P ER Z K R AY B D 
suppose	S AH P OW Z
sure	SH UH R
sure,	SH UH R
sure.	SH UH R
Surely.	SH UH R L IY
surpliced	S ER P L AY S T 
surprise	S ER P R AY Z
surprise(2)	S AH P R AY Z
surprise,	S ER P R AY Z
surprise,(2)	S AH P R AY Z
surprise.	S ER P R AY Z
surprise.(2)	S AH P R AY Z
surrounded	S ER AW N D AH D
surrounded(2)	S ER AW N D IH D
suspected.	S AH S P EH K T AH D
suspected.(2)	S AH S P EH K T IH D
suspicion.	S AH S P IH SH AH N
suspicious,	S AH S P IH SH AH S
Sutherland,	S AH DH ER L AH N D
swiftly	S W IH F T L IY
swiftly,	S W IH F T L IY
sympathetic	S IH M P AH TH EH T IH K
sympathy	S IH M P AH TH IY
system	S IH S T AH M
t	T IY
t'	T IY
table	T EY B AH L
table,	T EY B AH L
table.	T EY B AH L
tags	T AE G Z
take	T EY K
taken	T EY K AH N
takes	T EY K S
taking	T EY K IH NG
tales	T EY L Z
talking	T AO K IH NG
tall,	T AO L
tap.	T AE P
task	T AE S K
taste.	T EY S T
tattoo	T AE T UW
tattooed	T AE T UW D
tell	T EH L
Tell	T EH L
tell,	T EH L
telling	T EH L IH NG
temperament	T EH M P R AH M AH N T
temperament(2)	T EH M P ER M AH N T
Temple	T EH M P AH L
Temple,	T EH M P AH L
Temple.	T EH M P AH L
ten	T EH N
Ten	T EH N
ten,	T EH N
terms	T ER M Z
texture	T EH K S CH ER
than	DH AE N
than(2)	DH AH N
thank	TH AE NG K
Thank	TH AE NG K
thanking	TH AE NG K IH NG
that	DH AE T
that(2)	DH AH T
That	DH AE T
That(2)	DH AH T
that,	DH AE T
that,(2)	DH AH T
that?	DH AE T
that?(2)	DH AH T
that.	DH AE T
that.(2)	DH AH T
that's	DH AE T S
the	DH AH
the(2)	DH IY
The	DH AH
The(2)	DH IY
THE	DH AH
THE(2)	DH IY
their	DH EH R
them	DH EH M
them(2)	DH AH M
them,	DH EH M
them,(2)	DH AH M
them.	DH EH M
them.(2)	DH AH M
then	DH EH N
Then	DH EH N
then,	DH EH N
Then,	DH EH N
then?	DH EH N
then.	DH EH N
theories	TH IH R IY Z
theories(2)	TH IY ER IY Z
theories,	TH IH R IY Z
theories,(2)	TH IY ER IY Z
theorize	TH IY ER AY Z
there	DH EH R
There	DH EH R
there,	DH EH R
there?	DH EH R
there's	DH EH R Z
There's	DH EH R Z
therefore,	DH EH R F AO R
these	DH IY Z
these:	DH IY Z
they	DH EY
They	DH EY
thick	TH IH K
Thick	TH IH K
thick,	TH IH K
thing	TH IH NG
thing.	TH IH NG
things	TH IH NG Z
things,	TH IH NG Z
think	TH IH NG K
think,	TH IH NG K
think.	TH IH NG K
thinking	TH IH NG K IH NG
thinks	TH IH NG K S
thirty	TH ER D IY
thirty(2)	TH ER T IY
this	DH IH S
This	DH IH S
THIS	DH IH S
this,	DH IH S
this.	DH IH S
thoroughly	TH ER OW L IY
those	DH OW Z
though	DH OW
thought	TH AO T
thought,	TH AO T
thousands	TH AW Z AH N D Z
thousands(2)	TH AW Z AH N Z
threatened	TH R EH T AH N D
Threatens	TH R EH T AH N Z
three	TH R IY
threw	TH R UW
through	TH R UW
throw	TH R OW
throw,	TH R OW
throwing	TH R OW IH NG
thrown	TH R OW N
thrust	TH R AH S T
Thumb	TH AH M
Thursday	TH ER Z D EY
Thursday(2)	TH ER Z D IY
tie	T AY
tie,	T AY
till	T IH L
time	T AY M
time,	T AY M
time.	T AY M
times	T AY M Z
times,	T AY M Z
times.	T AY M Z
tint,	T IH N T
tint.	T IH N T
title	T AY T AH L
Title:	T AY T AH L
to	T UW
to(2)	T IH
to(3)	T AH
To	T UW
To(2)	T IH
To(3)	T AH
TO	T UW
TO(2)	T IH
TO(3)	T AH
to-day	T AH D EY 
to-morrow	T AH M AA R OW 
to-morrow,	T AH M AA R OW 
to-morrow?	T AH M AA R OW 
to-morrow.	T AH M AA R OW 
to-night,	T AH N AY T 
to.	T UW
to.(2)	T IH
to.(3)	T AH
toast	T OW S T
tobacco,	T AH B AE K OW
together	T AH G EH DH ER
together,	T AH G EH DH ER
together.	T AH G EH DH ER
told	T OW L D
too	T UW
Too	T UW
too,	T UW
too.	T UW
took	T UH K
top	T AA P
top(2)	T AO P
top-hat	T AA P HH AE T 
tops	T AA P S
tore	T AO R
tossed	T AO S T
towards	T AH W AO R D Z
towards(2)	T AO R D Z
town	T AW N
track,	T R AE K
tradesman,	T R EY D S M AH N 
tragedy	T R AE JH AH D IY
train	T R EY N
trained	T R EY N D
tramped	T R AE M P T
transferred	T R AE N S F ER D
travelled.	T R AE V AH L D
tray	T R EY
treachery	T R EH CH ER IY
Trepoff	T R EH P AO F 
trick	T R IH K
trick.	T R IH K
tried	T R AY D
trifle	T R AY F AH L
trifling	T R AY F L IH NG
trimmed	T R IH M D
Trincomalee,	T R IH NG K OW M AH L IY
triumphant	T R AY AH M F AH N T
trooped	T R UW P T
trousers,	T R AW Z ER Z
true	T R UW
true.	T R UW
truly	T R UW L IY
trust	T R AH S T
trusted	T R AH S T IH D
trustees	T R AH S T IY Z
trustees,	T R AH S T IY Z
Try	T R AY
tugged	T AH G D
turn	T ER N
turn.	T ER N
turned	T ER N D
Turner	T ER N ER
turning	T ER N IH NG
tweed-suited	T W IY D S UW T AH D 
twelve,	T W EH L V
twentieth	T W EH N T IY AH TH
twentieth(2)	T W EH N T IY IH TH
twentieth(3)	T W EH N IY AH TH
twentieth(4)	T W EH N IY IH TH
twenty	T W EH N T IY
twenty(2)	T W EH N IY
twenty-five	T W EH N T IY F AY V 
twenty-one	T W EH N T IY W AA N 
twice	T W AY S
Twice	T W AY S
twice.	T W AY S
twist	T W IH S T
Twisted	T W IH S T AH D
Twisted(2)	T W IH S T IH D
two	T UW
Two	T UW
two.	T UW
twopence,	T OW P AH N S 
tying	T AY IH NG
U.	Y UW
ulster	AH L S T ER
ulster.	AH L S T ER
unbuttoned	AH N B AH T AH N D
uncertain	AH N S ER T AH N
uncontrollable	AH N K AH N T R OW L AH B AH L
uncourteous	AA N K AO ER T IY AH S 
undated,	AH N D EY T IH D
under	AH N D ER
understand	AH N D ER S T AE N D
understand,	AH N D ER S T AE N D
understand?	AH N D ER S T AE N D
unexpected	AH N IH K S P EH K T IH D
unfortunate	AH N F AO R CH AH N AH T
unfortunate(2)	AH N F AO R CH UW N AH T
unique	Y UW N IY K
unique.	Y UW N IY K
unknown	AH N N OW N
unlikely	AH N L AY K L IY
unmarried	AH N M EH R IY D
unpleasantness.	AH N P L EH Z AH N T N AH S
until	AH N T IH L
Until	AH N T IH L
unusual.	AH N Y UW ZH AH W AH L
unusual.(2)	AH N Y UW ZH UW AH L
unusual.(3)	AH N Y UW ZH W AH L
up	AH P
up,	AH P
up.	AH P
upon	AH P AA N
upper	AH P ER
uproar.	AH P R AO R
us	AH S
us(2)	Y UW EH S
us,	AH S
us,(2)	Y UW EH S
us;	AH S
us;(2)	Y UW EH S
us.	AH S
us.(2)	Y UW EH S
use	Y UW S
use(2)	Y UW Z
used	Y UW Z D
useful,	Y UW S F AH L
usual,	Y UW ZH AH W AH L
usual,(2)	Y UW ZH UW AH L
utmost	AH T M OW S T
V.	V IY
vacancies	V EY K AH N S IY Z
vacancies.	V EY K AH N S IY Z
vacancy	V EY K AH N S IY
vacancy,	V EY K AH N S IY
vague	V EY G
Valley	V AE L IY
value	V AE L Y UW
values	V AE L Y UW Z
vanished	V AE N IH SH T
vary	V EH R IY
veil	V EY L
velvet	V EH L V AH T
verbs.	V ER B Z
very	V EH R IY
Very	V EH R IY
Very,	V EH R IY
VI.	V AY
VI.(2)	V IY
VI.(3)	V IY AY
vice	V AY S
view,	V Y UW
VII.	V IY AY AY 
VIII.	V IY AY AY AY 
vile	V AY L
villa,	V IH L AH
Vincent	V IH N S AH N T
Vincent(2)	V IH N S IH N T
visible	V IH Z AH B AH L
visit	V IH Z AH T
visit(2)	V IH Z IH T
visitor	V IH Z AH T ER
visitor(2)	V IH Z IH T ER
visitor,	V IH Z AH T ER
visitor,(2)	V IH Z IH T ER
visitor.	V IH Z AH T ER
visitor.(2)	V IH Z IH T ER
visits?	V IH Z AH T S
visits?(2)	V IH Z IH T S
vivid	V IH V AH D
vivid(2)	V IH V IH D
vizard	V AY Z ER D 
voice	V OY S
voices.	V OY S AH Z
voices.(2)	V OY S IH Z
volume	V AA L Y UW M
volunteer	V AA L AH N T IH R
von	V AO N
Von	V AO N
vouching	V AW CH IH NG
wages	W EY JH AH Z
wages(2)	W EY JH IH Z
waistcoat	W EY S T K OW T 
wait	W EY T
wait,	W EY T
wait.	W EY T
waited	W EY T AH D
waited(2)	W EY T IH D
waiting	W EY T IH NG
waiting,	W EY T IH NG
waiting.	W EY T IH NG
walk	W AO K
walk(2)	W AA K
walked	W AO K T
walking-clothes,	W AO K IH NG K L OW DH Z 
walks	W AO K S
wall	W AO L
Wallenstein,	W AO L AH N S T AY N
Wallenstein,(2)	W AO L AH N S T IY N
want	W AA N T
want(2)	W AO N T
wanted	W AA N T AH D
wanted(2)	W AO N T IH D
wanted(3)	W AO N IH D
warmly	W AO R M L IY
warned	W AO R N D
Warsaw	W AO R S AO
Warsaw,	W AO R S AO
was	W AA Z
was(2)	W AH Z
was(3)	W AO Z
Was	W AA Z
Was(2)	W AH Z
Was(3)	W AO Z
was,	W AA Z
was,(2)	W AH Z
was,(3)	W AO Z
was;	W AA Z
was;(2)	W AH Z
was;(3)	W AO Z
was?	W AA Z
was?(2)	W AH Z
was?(3)	W AO Z
was.	W AA Z
was.(2)	W AH Z
was.(3)	W AO Z
watch	W AA CH
watch(2)	W AO CH
watch-chain	W AA CH CH EY N 
watch-chain,	W AA CH CH EY N 
watched	W AA CH T
watched(2)	W AO CH T
watching	W AA CH IH NG
water	W AO T ER
Watson	W AA T S AH N
Watson,	W AA T S AH N
Watson.	W AA T S AH N
waved	W EY V D
waving	W EY V IH NG
wax	W AE K S
way	W EY
way,	W EY
way:	W EY
waylaid	W EY L EY D
waylaid.	W EY L EY D
ways.	W EY Z
we	W IY
We	W IY
weapon	W EH P AH N
wear	W EH R
wearing	W EH R IH NG
weather,	W EH DH ER
wedged	W EH JH D
Wedlock	W EH D L AA K
week	W IY K
week,	W IY K
week.	W IY K
week's	W IY K S
weeks	W IY K S
weeks,	W IY K S
weight	W EY T
well	W EH L
well-dressed	W EH L D R EH S T 
well-known	W EH L N OW N 
well-remembered	W EH L R IH M EH M B ER D 
well,	W EH L
Well,	W EH L
Well!	W EH L
well.	W EH L
went	W EH N T
went,	W EH N T
were	W ER
west	W EH S T
wet	W EH T
what	W AH T
what(2)	HH W AH T
What	W AH T
What(2)	HH W AH T
What!	W AH T
What!(2)	HH W AH T
whatever.	W AH T EH V ER
whatever.(2)	HH W AH T EH V ER
whatsoever.	W AH T S OW EH V ER
whatsoever.(2)	HH W AH T S OW EH V ER
wheel,	W IY L
wheel,(2)	HH W IY L
wheels	W IY L Z
wheels(2)	HH W IY L Z
wheels.	W IY L Z
wheels.(2)	HH W IY L Z
when	W EH N
when(2)	HH W EH N
when(3)	W IH N
when(4)	HH W IH N
When	W EH N
When(2)	HH W EH N
When(3)	W IH N
When(4)	HH W IH N
When,	W EH N
When,(2)	HH W EH N
When,(3)	W IH N
When,(4)	HH W IH N
When?	W EH N
When?(2)	HH W EH N
When?(3)	W IH N
When?(4)	HH W IH N
whence	W EH N S
whence(2)	HH W EH N S
where	W EH R
where(2)	HH W EH R
Where	W EH R
Where(2)	HH W EH R
Where,	W EH R
Where,(2)	HH W EH R
whether	W EH DH ER
whether(2)	HH W EH DH ER
which	W IH CH
which(2)	HH W IH CH
Which	W IH CH
Which(2)	HH W IH CH
which.	W IH CH
which.(2)	HH W IH CH
while	W AY L
while(2)	HH W AY L
whispered	W IH S P ER D
whispered(2)	HH W IH S P ER D
whistled.	W IH S AH L D
whistled.(2)	HH W IH S AH L D
white	W AY T
white(2)	HH W AY T
who	HH UW
whole	HH OW L
whom	HH UW M
Whom	HH UW M
whom?	HH UW M
whose	HH UW Z
why	W AY
why(2)	HH W AY
Why	W AY
Why(2)	HH W AY
Why,	W AY
Why,(2)	HH W AY
why?	W AY
why?(2)	HH W AY
widened	W AY D AH N D
widower	W IH D OW ER
wife	W AY F
wigs	W IH G Z
Wilhelm	W IH L HH EH L M
will	W IH L
will(2)	W AH L
Will	W IH L
Will(2)	W AH L
will,	W IH L
will,(2)	W AH L
willing	W IH L IH NG
Wilson	W IH L S AH N
Wilson,	W IH L S AH N
Wilson!	W IH L S AH N
Wilson?	W IH L S AH N
Wilson.	W IH L S AH N
wind.	W AY N D
wind.(2)	W IH N D
window	W IH N D OW
window,	W IH N D OW
window.	W IH N D OW
windows	W IH N D OW Z
wire	W AY ER
wire(2)	W AY R
wish	W IH SH
wish?	W IH SH
wished	W IH SH T
wishes	W IH SH IH Z
wit.	W IH T
with	W IH DH
with(2)	W IH TH
With	W IH DH
With(2)	W IH TH
withdraw	W IH DH D R AO
withdraw(2)	W IH TH D R AO
within	W IH DH IH N
within(2)	W IH TH IH N
without	W IH TH AW T
without(2)	W IH DH AW T
witness	W IH T N AH S
wits'	W IH T S
woman	W UH M AH N
woman,	W UH M AH N
woman!	W UH M AH N
woman.	W UH M AH N
woman's	W UH M AH N Z
Women	W IH M AH N
women,	W IH M AH N
won't	W OW N T
wonder	W AH N D ER
wonderful	W AH N D ER F AH L
wondering	W AH N D ER IH NG
Wood.	W UH D
wooden	W UH D AH N
wooing,	W UW IH NG
word	W ER D
word,	W ER D
words	W ER D Z
wore	W AO R
work	W ER K
work,	W ER K
work?	W ER K
work.	W ER K
worked	W ER K T
worker.	W ER K ER
world	W ER L D
worth	W ER TH
worth?	W ER TH
would	W UH D
Would	W UH D
would,	W UH D
would.	W UH D
woven	W OW V AH N
wriggled	R IH AH L D 
wrinkled	R IH NG K AH L D
wrist	R IH S T
writes	R AY T S
writing	R AY T IH NG
writing,	R AY T IH NG
writing?	R AY T IH NG
writing.	R AY T IH NG
written	R IH T AH N
written,	R IH T AH N
written.	R IH T AH N
wronged.	R AO NG D
wrote	R OW T
wrung	R AH NG
www.gutenberg.net	D AA B AH L Y UW D AA B AH L Y UW D AA B AH L Y UW G AA T AH N B ER G N EH T 
X.	EH K S
XI.	SH IY
XII.	EH K S AY AY 
yawn.	Y AO N
year	Y IH R
year,	Y IH R
years	Y IH R Z
years(2)	Y ER Z
years,	Y IH R Z
years,(2)	Y ER Z
years;	Y IH R Z
years;(2)	Y ER Z
yelled	Y EH L D
Yes,	Y EH S
yes!	Y EH S
Yes.	Y EH S
Yesterday.	Y EH S T ER D EY
Yesterday.(2)	Y EH S T ER D IY
yet	Y EH T
Yet	Y EH T
yet,	Y EH T
Yet,	Y EH T
yet?	Y EH T
yet.	Y EH T
you	Y UW
You	Y UW
you,	Y UW
You,	Y UW
you?	Y UW
you.	Y UW
You'll	Y UW L
young	Y AH NG
young,	Y AH NG
young.	Y AH NG
your	Y AO R
your(2)	Y UH R
Your	Y AO R
Your(2)	Y UH R
yours	Y UH R Z
yours(2)	Y AO R Z
yours(3)	Y ER Z
yours,	Y UH R Z
yours,(2)	Y AO R Z
yours,(3)	Y ER Z
yours.	Y UH R Z
yours.(2)	Y AO R Z
yours.(3)	Y ER Z
yourself	Y ER S EH L F
yourself(2)	Y UH R S EH L F
yourself(3)	Y AO R S EH L F
yourself,	Y ER S EH L F
yourself,(2)	Y UH R S EH L F
yourself,(3)	Y AO R S EH L F
yourselves,	Y UH R S EH L V Z
yourselves,(2)	Y AO R S EH L V Z
youth	Y UW TH
youth,	Y UW TH
youth?	Y UW TH
